#13X13
0 1 - 2 - - 2 0 1 0 1 0 1
2 - 4 - 1 0 | 0 | 0 | 0 |
| 0 H 1 - - 5 = 7 = 7 = 4
3 = 7 - - 3 | 0 H 0 H 0 |
0 0 H 0 1 H 3 = 5 - 5 - 4
0 0 H 0 | 4 - 4 - 1 | 0 H
2 - 6 - 4 | 0 H 2 = 3 0 H
| 0 H 0 H 3 = 5 - 2 - - 4
3 = 8 = 7 = 5 - 2 - - 1 |
0 0 H 0 | 0 H 1 - - 2 - 3
2 - 4 - 5 - 4 - - 2 - 1 |
| 0 0 0 H 0 0 0 1 - 2 - 2
1 0 1 - 4 - 2 - - 2 - 1 0