#13X13
2 - 2 - 2 - - - - 2 - 1 0
| 3 = 5 - - 3 - 3 - 4 - 2
2 | 0 H 0 0 | 1 | 0 H 0 |
| 2 - 6 = = 3 | 3 = 4 0 |
| 0 0 | 2 - - 3 - 4 - - 3
3 - 2 | | 0 2 - 2 H 0 0 |
| 0 | 2 | 0 | 0 | 4 - 1 |
| 0 1 | 2 - 3 0 | | 1 - 3
2 - - 4 - 1 | 0 1 | 0 0 |
0 0 1 | 1 - 4 - - 3 - 1 |
0 0 | 2 - 1 | 0 0 0 1 - 3
1 - 3 - 3 = 4 - 1 0 0 0 |
0 1 - 3 = 3 - 2 - 2 - - 2