#13X13
2 - - 3 = 3 - 2 - 4 - 2 0
| 1 - - 5 = 6 = 3 H 0 | 1
| 0 0 0 H 1 H 0 | 4 = 4 |
2 0 1 - 4 | H 0 | 0 0 | 2
| 3 - 1 | | 5 - 5 = = 4 |
2 H 0 0 | 3 H 0 | 0 0 | 2
| 5 - - 3 H 5 = 5 - 1 | |
2 H 0 0 | 3 | 0 | 0 0 | |
| 5 = = 4 | 1 0 | 2 = 3 |
| | 0 1 | 2 - - 4 - 2 - 3
| 2 0 | | 0 0 0 | 0 0 0 |
1 | 0 | 2 - 2 - 3 - - 1 |
0 2 - 2 0 1 - 2 - 2 - - 2