#13X13
2 - - 3 - 3 = 3 - 2 - 1 0
| 0 1 | 3 = 3 - 3 - 5 = 3
| 0 | 3 | 2 - 1 | 0 H 0 |
2 - 4 H 3 | 2 = 3 0 H 0 |
0 0 H 2 H 3 = 3 - - 6 - 3
2 - 6 - 5 - 4 - 3 0 H 0 |
| 0 H 0 | 0 H 0 H 0 H 0 |
| 0 H 0 3 = 6 = 6 - 7 = 4
4 = 6 - - 2 - 1 | 1 H 0 |
| 0 | 0 4 = 5 = 3 | 4 - 2
2 0 | 0 H 0 | 2 = 4 | 0 0
| 0 2 - 4 - 3 - 1 | 1 0 0
2 - - 3 = 3 - 2 - 3 - - 1