#13X13
0 2 - 2 0 1 - - 2 - 2 - 2
1 | 0 | 0 0 0 1 - 5 = 3 |
| 1 0 | 3 - 2 - 1 H 0 | 2
2 - - 3 H 1 - 5 = 6 - 2 |
0 0 0 | H 0 0 H 0 | 0 0 |
2 - 1 | 3 - - 4 - 4 - - 4
| 0 0 | 0 0 0 0 0 | 0 0 H
3 - - 6 = 5 = = 4 | 1 - 4
| 0 0 H 1 | 0 0 H | 0 0 |
| 2 - 3 | 2 - 1 H 3 - - 4
2 | 1 - 3 - 2 - 3 | 0 1 H
| 2 - 2 - 3 = 2 0 | 0 | 2
2 - 2 - 2 - 2 - - 3 - 2 0