#13X13
2 - - 3 0 1 0 1 0 0 2 - 2
| 0 0 H 0 | 1 | 0 0 | 0 |
4 = = 7 = 3 | 2 - 2 | 1 |
| 0 0 | 0 0 | 0 0 | 1 | |
| 2 - 4 - - 4 - - 2 0 | 2
| | 2 | 1 0 | 0 3 - - 3 |
2 | H 3 | 1 | 2 H 1 0 | 2
| 2 H H 2 | 1 H 2 | 0 | |
2 | H 2 | 2 - 6 - 5 = 3 |
| | 4 - 3 - 2 H 0 | 0 0 |
| 1 | 1 - 2 | 5 = 7 = = 4
| 0 | 0 0 | 1 | 0 H 0 0 |
2 - 3 - - 3 - 2 0 3 - - 2