#13X13
2 - - 3 = 3 - 2 - - 2 - 2
| 0 2 - 2 - 4 = 4 - - 1 |
2 0 | 0 0 0 | 1 | 0 3 - 3
| 0 4 = = 2 | | | 0 H 0 |
| 0 | 1 - - 2 | 4 = 8 = 4
2 - 6 = 4 - - 2 | 0 H 0 |
0 0 H 0 | 0 0 0 | 0 H 0 |
0 0 H 0 | 2 = = 4 - 5 - 3
2 - 6 - 4 - 4 - - 1 | 0 |
| 0 H 0 | 1 H 0 2 - 4 0 |
3 = 4 0 | | H 0 | 0 H 0 2
0 1 - - 2 | 3 - 4 = 4 0 |
1 - 2 - - 3 - 2 - 2 - - 2