#13X13
0 1 - 2 - - - 3 - - 2 - 2
2 - 2 - - 2 0 | 0 3 = 4 |
| 2 - - 1 | 0 | 0 | 0 H 2
2 | 1 - - 3 - 6 = 4 - 4 |
| 3 - 2 - - 1 H 0 0 0 | 2
| | 0 0 0 0 0 H 1 - - 3 |
2 | 1 - - 5 = 6 - - 1 | 2
| 3 - - 1 H 0 | 0 0 0 | |
2 | 2 = = 5 - 4 - 2 - 3 |
| 4 - 3 - - 2 | 0 0 0 | 2
2 H 0 | 0 0 | | 2 = = 4 |
| 4 = 4 - 1 | 3 = = 2 | 1
2 - 2 - 2 - 2 0 0 1 - 2 0