#13X13
0 1 - - 2 - 2 0 1 - 4 - 2
3 = = 5 - 1 | 0 0 0 H 0 |
| 0 0 H 2 - 5 = 6 = 7 = 4
2 - - 5 | 2 | 0 H 0 | 0 |
0 0 0 H 1 H 2 - 4 - 2 0 |
2 - - 4 - 5 = 5 - 5 = = 4
| 1 - - 2 - 2 H 1 H 0 0 |
2 - - 2 - 1 | 2 | 4 - - 4
0 0 2 - 4 - 4 - 4 | 0 0 H
0 0 | 0 H 0 | 0 H 4 = = 5
3 = 7 = 7 = 7 = 4 | 0 0 |
| 0 H 0 | 0 H 0 0 | 1 - 2
2 - 3 0 2 - 4 - - 3 - 1 0