#13X13
2 - - 2 - 2 - 2 - 2 - 1 0
| 1 - - 4 - - - 3 = 3 - 2
| 0 0 0 H 0 3 - - 3 - 3 |
2 - 3 - 4 0 H 0 1 | 0 H 2
0 2 | 0 | 0 3 0 | 3 = 5 |
1 H 1 0 | 0 | 0 | 0 0 | 3
| 4 - - 3 - 4 - 5 = = 4 H
| | 3 = = 3 | 0 | 0 1 | 3
2 | | 0 1 | 3 0 | 0 | 2 |
| 2 | 0 | 1 H 0 3 - 3 | 2
2 | 2 - 5 = 5 0 | 0 | | |
| 2 - 1 | 0 | 0 1 0 | 1 |
2 - 2 - 2 0 1 0 0 0 2 - 2