#9X9
0 0 0 0 0 0 0 0 0
0 0 0 0 0 0 0 0 0
0 0 1 0 3 - 2 0 0
0 0 | 0 H 0 | 0 0
0 0 3 = 8 = 4 0 0
0 0 0 0 H 0 | 0 0
0 0 0 0 2 0 1 0 0
0 0 0 0 0 0 0 0 0
0 0 0 0 0 0 0 0 0
