#9X9
0 0 0 0 0 0 0 0 0
0 2 0 2 - - 2 0 0
0 H 0 | 0 0 | 1 0
0 6 = 5 - 3 | | 0
0 H 1 | 0 H | 3 0
0 3 | 1 0 H 1 H 0
0 | 3 = = 6 = 4 0
0 3 = 2 0 0 0 0 0
0 0 0 0 0 0 0 0 0
