#9X9
3 - 3 0 2 0 1 - 3
H 0 H 0 H 0 0 0 H
H 0 4 = 8 = = = 6
6 = = 2 H 0 0 0 H
H 0 3 = 5 - - 3 H
H 0 | 3 - - 1 H 3
3 0 1 H 0 2 = 5 |
| 0 0 H 0 0 0 | 1
1 0 0 3 - 2 - 2 0
