#9X9
2 - - 3 - - 1 0 0
| 0 0 | 1 - - - 3
| 1 - 4 - 2 - 1 H
3 - 1 | 4 = 5 = 6
| 2 = 3 H 0 | 0 H
3 - 3 = 5 - 3 - 4
| 3 = 6 = 4 - 1 |
1 | 0 H 0 | 0 0 |
0 2 - 3 0 2 - - 2
