#9X9
1 0 2 - 2 - 2 - 2
| 0 | 2 - 2 - 1 |
3 = 4 | 0 0 0 0 |
0 1 | 2 - - 2 - 3
1 | | 0 0 0 0 0 |
| | 2 - - 3 - - 3
| | 0 0 0 | 0 0 |
| 2 - 2 - 3 - 1 |
2 - 2 - 2 - 2 - 2
