#9X9
0 2 - - 2 0 2 - 2
1 | 0 0 | 0 | 0 |
| 3 - 1 | 0 1 0 |
2 | 1 - 3 - - - 4
| 2 - 2 - 2 - 1 H
3 - - - 2 - 3 - 5
| 0 2 - - 1 | 0 H
| 0 | 2 = = 5 = 4
2 - 3 - 2 - - 1 0
