#9X9
2 - 4 - - 3 - 2 0
| 0 H 0 0 | 0 | 1
3 = 7 - 2 | 2 | |
0 0 H 1 | 1 H 1 |
2 - 3 | 2 - 6 - 3
| 3 - 3 - 1 H 0 |
| H 0 0 1 - 6 = 4
1 H 0 0 0 0 | 0 |
0 3 - 2 - - 2 0 1