#9X9
2 - 2 - 2 - 2 - 2
| 1 - 4 - 2 - 2 |
| 0 0 H 0 0 0 | 2
2 0 0 4 - - 1 | |
| 0 0 | 2 - - 2 |
| 2 - 3 | 1 - - 3
2 | 0 | | 0 0 0 |
| 1 0 | 2 - 2 - 2
1 0 0 2 - 2 - 1 0