#9X9
2 - - 2 - - 1 0 0
| 1 - - - 2 - - 2
3 - - 2 - - - 1 |
| 0 2 - 2 - 3 - 3
| 0 | 3 - 2 | 0 |
3 - 2 H 0 | 1 0 |
| 3 = 8 = 6 = = 5
1 | 0 H 0 | 0 0 H
0 2 - 3 0 2 - - 3