#9X9
2 0 2 - 2 0 1 - 2
H 0 | 0 | 1 - 2 |
4 = 5 0 | 0 0 | 2
0 1 H 0 2 - - 3 |
1 | 3 - - - 2 | 2
| 3 - - 2 0 | 1 |
2 | 0 0 | 0 4 = 4
| 2 - 1 | 0 | 0 |
2 - 2 - 3 - 2 0 1