#9X9
0 2 - - - 2 - 1 0
0 | 0 2 - - 3 - 2
1 | 0 | 0 0 | 1 |
| 4 - 5 = 4 | | 2
3 H 0 | 0 H 1 | |
H 5 = 5 - 5 - 4 |
3 | 0 | 0 | 0 H 1
| 1 0 | 0 3 = 4 0
2 - - 3 - - 2 - 1