#9X9
1 - - 3 - 2 - 2 0
0 0 0 | 0 0 0 | 1
2 - 2 | 3 - - 2 |
| 1 | 2 H 0 3 = 5
2 | 1 | 3 0 | 0 H
| 2 - 3 | 0 | 0 H
| 0 0 | 2 - 3 - 4
2 - - 3 - - - 1 |
0 1 - - - 2 - - 2