#9X9
0 1 - - 3 - - 2 0
0 0 0 0 | 0 0 | 1
2 - 3 = 5 - 1 | |
| 3 = 2 | 3 = 5 |
2 | 2 = 3 | 0 H 3
| 3 - 2 - 3 - 3 H
| | 2 = 4 - 2 - 3
1 | 0 0 | 0 0 0 0
0 2 - - 3 - - 1 0