#9X9
0 2 - 3 - - 3 - 2
1 | 1 | 0 0 | 0 |
| 1 | 3 = 4 | 2 |
2 - 5 = 2 H 3 H 2
0 0 | 1 - 4 H 3 |
0 0 4 = 2 | 4 | 3
1 0 | 1 - 3 H 2 H
| 0 | 0 0 | 2 | 2
2 - 3 - - 3 - 2 0