#13X13
2 - 2 - - 2 - 3 - 2 - 1 0
| 4 = 3 0 0 0 | 3 = 5 - 3
2 H 0 | 0 0 0 1 | 0 H 0 H
| 4 - 3 - 3 - - 5 - 3 0 H
2 | 0 0 0 | 0 2 H 1 - - 4
| | 3 - 2 | 0 H 4 - - 3 |
| 2 H 0 | 3 - 4 | 0 0 H 2
| | 4 = 4 | 0 | 2 - 1 H |
| 3 - 1 | 1 0 | 0 0 0 H 2
2 | 3 - 5 = = 5 - 4 - 4 |
| 1 H 0 | 1 0 | 0 H 0 | 2
2 - 5 = 3 | 0 | 0 4 = 3 |
0 1 - 2 - 3 - 2 0 0 1 - 2