#13X13
0 1 - 3 = 3 - 2 - 2 0 0 1
3 - 5 = 4 - 3 = 3 | 0 0 |
H 1 H 1 | 1 - 2 | 4 = 4 |
H | H | | 0 0 | 1 | 0 H 2
3 | 2 | 4 = = 4 - 5 - 4 |
| 4 - 3 | 4 = = 3 H 0 | 2
| H 0 | 1 H 0 0 | H 0 | |
2 H 0 | 0 H 0 0 | 4 = 4 |
| 5 = 6 - 7 = = 7 = 3 | |
| | 0 H 0 H 0 0 H 0 | | 2
2 | 0 5 = 7 = 3 H 0 | 1 |
| 1 0 | 0 | 0 | 3 - 3 - 2
2 - - 2 0 1 0 2 - 2 - 1 0