#13X13
0 1 - - - 2 - 2 0 2 - - 2
2 - - 4 = = 4 | 0 | 1 0 |
| 0 0 | 0 0 H 5 = 4 | 0 2
| 3 - 4 - - 3 H 0 | | 0 |
3 H 0 | 0 0 0 H 0 | 5 = 4
H 6 = 6 = 6 = 7 = 5 H 0 |
3 H 0 | 0 H 0 | 0 H 3 - 3
| 4 - 3 - 6 - 4 - 6 - 2 |
2 | 0 0 0 H 0 | 0 H 0 | 2
| 2 - - - 6 = 7 = 7 = 3 |
3 - - 1 0 | 0 H 0 | 0 0 |
| 0 1 - - 3 - 4 - 3 - - 2
2 - - 2 - - 2 - 2 - - 1 0