#13X13
2 - 2 - - 2 - 2 - 2 - 2 0
| 1 - 2 - - 2 - 4 = 2 | 1
2 - 4 - 3 - - 1 | 0 0 | |
0 0 H 0 | 3 = = 5 - - 3 |
2 - 7 = 5 | 0 0 | 0 0 | 2
| 0 H 0 H 3 = 2 | 1 - 2 |
4 = 6 = 7 = 4 = 6 = 5 - 3
| 2 - 1 | 1 - 3 | 0 H 0 |
2 | 0 0 | 0 0 H 2 - 7 = 4
| 3 - - 4 - - 4 - 1 H 0 |
1 | 0 1 | 1 - - 2 - 4 - 3
0 | 0 | 2 - 3 = = 3 - 1 |
0 2 - 2 0 1 - - 2 - 2 - 2