#13X13
1 0 2 - - 2 0 2 - - 2 0 1
| 0 | 0 1 | 2 | 2 0 | 0 |
| 0 | 0 | 1 H 1 H 0 | 0 2
3 = 5 - 6 = 6 - 4 - 2 0 |
0 0 | 0 H 0 | 1 - - - - 3
1 0 | 0 3 - 3 - - 2 - 1 |
| 0 5 = = 4 - 4 - - 4 = 5
| 0 H 0 0 | 1 H 1 0 | 0 H
3 = 5 - - 2 | 2 | 0 | 0 H
0 1 - - 2 - 4 - 5 = 4 - 5
3 - - 3 = 2 | 2 | 0 0 0 H
H 0 1 - 2 - 2 H 1 0 0 0 H
3 - - 2 - 2 - 4 - - 2 - 3