#13X13
0 2 - 3 = 3 - 2 - 2 - 1 0
1 | 1 - 3 = 5 - 3 - 4 - 2
| | 0 0 0 0 H 0 | 0 H 0 |
| 4 - 2 - - 6 = 3 0 H 0 |
2 H 1 - 2 0 | 3 = = 8 = 4
| H 0 0 | 0 1 | 0 0 H 0 |
| 3 - - 4 - - 4 - - 6 - 3
| 0 0 0 | 0 1 | 0 0 H 0 |
3 - - 1 | 0 | 4 = = 6 = 4
| 0 3 = 7 = 4 | 1 - - 2 |
| 0 | 0 H 0 | 2 - - 1 | 3
2 - 3 - 4 - 3 - - 3 = 3 H
0 1 - 3 = 3 - - 2 - - - 3