#13X13
2 - 2 - 2 - 2 - - 2 0 0 1
| 3 = 5 - 3 - - 1 | 0 0 |
2 | 0 H 0 | 0 0 0 | 1 - 3
| 3 - 7 = 7 = 4 - 6 = 2 |
2 | 0 H 0 H 0 | 0 H 0 0 |
| 4 = 7 - 6 = 7 = 7 - - 3
2 | 0 H 0 | 0 H 0 H 0 0 |
| 3 - 7 = 6 - 5 - 6 - 2 |
2 | 0 H 1 H 0 | 0 H 0 | 2
| 4 = 4 | 4 = 7 = 7 = 5 |
2 | 0 0 | 0 0 H 0 | 0 H 2
| 1 0 0 2 - - 4 - 3 - 3 |
2 - - 2 - - 2 - 2 - 2 - 2