#13X13
0 1 - 2 - - 3 = 3 - 2 0 1
2 - 4 - 2 - - 2 - 1 | 0 |
| 0 H 2 - - 3 - 5 = 6 = 4
3 = 6 | 1 0 | 0 H 0 | 0 |
0 0 H 1 | 0 4 = 7 = 5 0 |
2 - 7 = 4 0 | 0 | 0 H 0 2
| 0 H 0 | 0 3 0 | 0 H 0 |
2 0 H 0 | 1 H 0 2 - 6 = 4
| 0 4 - 4 | 3 - - 1 | 0 |
| 0 | 0 H 3 = = 3 - 3 0 |
2 0 3 = 5 - 2 - - 1 | 0 2
| 1 - - - 2 - - 2 - 2 0 |
2 - - 2 - - - 2 - 2 - - 2