#13X13
0 2 - 3 - 2 0 0 1 0 1 - 3
1 | 2 | 0 | 0 0 | 2 - 3 H
| 1 H 2 0 | 0 0 | | 0 H 3
3 - 4 | 0 4 = = 3 | 0 H |
| 1 | 1 0 | 0 4 = 7 = 5 |
3 | 4 = = 4 0 H 0 H 1 | 2
H 2 | 0 0 | 0 4 - 4 | 2 |
3 | 2 - 1 | 0 | 0 | 2 | 2
| 5 = 5 = 3 0 | 0 1 | 1 |
| H 0 | 1 - - 6 = = 5 - 3
3 H 0 | 0 0 0 H 0 0 | 1 |
H 3 - 2 0 0 0 H 1 - 2 | 1
3 - 2 - 2 - - 4 - 2 - 2 0