#13X13
2 - 2 - 2 - - 2 0 0 1 0 0
| 1 - 4 = 3 0 | 0 0 | 0 1
2 - 3 | 1 | 0 3 - 1 | 0 |
0 0 H 1 | 3 0 | 2 - 5 - 3
2 - 4 - 2 H 0 1 | 0 H 0 |
| 1 - - - 5 = = 5 = 7 = 4
3 - - 4 - - 2 - - 1 | 0 |
| 0 1 H 3 = = 3 - - 2 0 |
| 0 | 2 | 1 - - 4 - - - 3
2 - 5 - 5 - - 2 H 0 0 0 |
0 0 H 0 H 0 0 | 3 - 2 - 3
1 - 5 = 6 = = 4 - 2 - 1 |
0 1 - 3 = = 3 - 3 = 3 - 2