#17X17
2 - 2 - - 2 0 1 - 2 - 2 - 2 - - 2
| 1 - 2 0 | 3 = 6 = 6 = 5 = 4 0 |
| 0 0 | 0 1 | 0 H 0 H 0 | 0 H 0 2
2 - - 3 - - 4 - 6 - 5 - 5 - 5 0 |
0 0 0 0 0 0 | 0 H 0 | 0 H 0 H 0 2
2 - 2 - 1 0 | 0 4 = 5 = 7 = 6 0 |
| 3 = 5 - - 5 = = 4 - 2 | 0 H 1 |
2 | 0 H 0 0 | 0 1 | 1 | | 0 H | 2
| | 1 H 3 = 5 0 | 2 | | 5 = 4 | |
2 | | H | 0 H 0 2 | 2 | H 0 0 | 2
| 2 | 2 | 0 H 0 | 1 | 1 H 3 - 3 |
| | 4 - 4 - 6 - 5 - 5 = 4 H 0 | 2
2 | H 0 | 0 H 0 H 0 | 0 0 H 0 1 |
| | 5 = 7 = 8 = 8 = 5 - - 5 - - 3
| 1 | 0 H 0 H 0 H 0 | 1 0 | 0 0 |
2 - 3 - 5 = 5 - 4 - 2 | 0 2 - 1 |
0 1 - 2 - 2 - 2 - 2 - 3 - - 2 - 2