#17X17
2 - 2 - 2 - 2 - - - 2 - 2 - 1 0 0
| 1 - 5 = 4 - 3 - 4 - 3 - 3 - - 2
| 0 0 H 0 | 2 | 0 H 0 | 1 | 0 0 |
2 - - 6 - 3 H | 0 H 0 1 | | 2 = 5
0 0 0 H 0 | H 4 = 6 - - 2 | 0 0 H
0 1 - 5 0 | 4 | 1 | 0 1 - 6 = = 5
2 - 2 H 0 | H | | 4 = = 4 H 0 0 |
| 0 | 5 = 3 H 1 | | 0 0 H 4 - - 3
| 0 1 | 0 0 H 0 | 2 - - 3 | 2 0 |
2 - - 5 - - 4 - 3 - 2 - - 3 H 0 |
0 0 0 H 2 = = 3 - 2 - 2 0 | 4 = 4
2 - - 4 - 2 - - 2 - 1 | 0 4 - 2 |
| 1 - - 2 - 2 - - 5 = 4 0 H 0 | |
2 - 2 - - 5 = 3 0 H 0 | 0 H 0 | 2
0 0 0 0 0 H 0 | 0 H 0 | 0 2 0 | |
1 - - 3 = 5 - 3 - 4 - 2 0 0 0 1 |
0 0 2 = = = 3 - 3 = 3 - - 2 - - 2