#17X17
0 2 - - 3 = 3 - 2 - - 2 - 2 - 1 0
1 | 0 4 = 4 - 5 = 4 - - 3 - 3 - 3
| 2 0 H 0 | 0 H 0 | 0 0 | 1 | 0 H
| | 0 5 - 5 = 6 - 6 = 3 | | | 0 H
2 | 0 H 0 | 0 | 0 H 0 | 1 | 3 = 5
| 4 = 8 = 3 0 | 0 H 0 | 0 | 0 0 |
| | 0 H 2 = = 7 = 6 - 5 - 4 - 3 |
| 4 - 7 = 3 0 H 0 | 0 H 0 | 0 H 2
| H 0 H 0 | 0 5 - 2 0 H 0 | 0 H |
2 H 0 H 0 | 0 H 1 - - 5 = 6 = 6 |
| 4 = 6 - 4 - 4 - - 2 - 2 | 0 H 2
| 0 0 | 0 | 1 - - 3 - 1 | 4 - 4 |
2 - 3 | 1 | 0 0 0 | 1 - 2 H 0 | 2
0 0 H | | 2 - 3 - 5 - 3 - 5 0 | |
0 0 H 1 | 0 0 | 0 H 0 | 0 H 0 2 |
1 - 4 - 3 - - 4 = 6 = 5 = 4 0 | 1
0 1 - 3 = 3 - - 2 - 2 - 2 - - 2 0