#17X17
0 2 = 3 - 2 - 2 0 1 0 1 - 4 - 2 0
2 - 3 - 1 0 0 | 0 | 0 0 0 H 0 | 1
| 0 | 2 - - 1 | 0 | 2 - - 5 = 4 |
| 0 1 | 3 = = 5 = 4 | 2 - - 1 | 3
3 - - 3 | 0 2 - 1 | 1 | 1 - - 4 H
| 1 0 | | 1 | 0 0 | 0 | 0 0 0 H H
2 | 0 | 1 | 2 - - 4 - 5 = 5 - 4 H
| 4 = 7 = 5 - - 2 | 0 | 0 H 0 | H
2 | 0 H 0 | 0 1 | 1 0 | 0 H 0 | 3
| | 0 H 0 | 0 | 2 - - 3 - 6 = 5 |
| 3 - 4 - 4 - 4 - - 3 - 1 | 0 H 3
2 | 0 0 0 | 0 | 0 1 | 3 = 7 = 5 H
| 3 - - 2 | 1 | 0 | 2 | 0 H 0 | 3
3 | 0 0 | 1 | | 1 | | 3 - 6 - 3 |
H 4 = 4 | 0 | 1 | | 1 | 0 H 0 | 3
2 | 0 H 3 = 4 - 2 | 0 | 0 4 = 3 H
0 2 - 3 0 1 - 2 - 3 - 3 - - 2 - 3