#17X17
2 - 2 - 2 - 2 - - 2 - - - 2 - - 2
| 2 - 4 = 5 - 1 0 0 0 3 - - 1 0 |
2 | 1 | 0 H 1 - - 2 0 H 0 3 = = 5
| | | 2 - 5 - 1 0 | 0 H 0 | 0 0 H
| 1 | 0 0 | 2 = = 6 = 8 = 5 - - 4
2 - 3 - 1 | 0 0 0 | 0 H 0 | 0 1 |
0 1 - 2 - 3 - 3 = 6 - 5 - 3 0 | |
2 - 3 = 4 - - - 1 H 0 | 1 | 0 | 2
| 2 = 4 | 0 1 - - 6 = 5 | 2 - 2 |
3 - 1 H 2 - - - 1 | 0 H 2 - 4 = 5
| 1 - 5 - 4 - 4 = 7 = 6 - 1 | 0 H
3 = 3 | 0 H 0 | 0 H 0 | 1 - 3 - 4
0 0 | 4 = 6 = 5 - 6 - 4 - - - 2 |
0 0 2 | 0 0 0 | 0 H 0 | 0 1 0 | 2
1 0 | 2 - - - 2 0 H 0 | 0 | 0 1 |
| 0 2 - - 2 - - - 5 = 4 - 2 0 0 |
2 - - 2 - - - 2 - - 2 - 2 - 2 - 2