#17X17
0 2 - 2 0 2 0 1 - 2 - 2 - - 2 - 2
0 | 1 | 0 H 1 - 2 - 4 = = 5 - 2 |
1 | | 3 = 6 - 4 - 1 | 0 0 H 0 | |
| 1 | 0 0 | 0 H 0 0 | 0 0 H 0 | 3
2 - 5 - - 5 = 7 - - 5 - - 6 = 5 H
0 0 H 0 0 | 1 H 0 2 H 0 1 | 0 H 3
2 - 6 = = 5 | H 0 H 2 0 | 3 - 5 |
| 0 | 1 0 H | 3 - 5 = 2 | | 0 H 2
| 1 | | 0 H 4 - 3 - 3 - 2 | 0 H |
2 | 2 | 0 2 H 0 | 0 | 2 = 6 = 6 |
| 2 | 3 - - 7 = 4 0 | 0 0 | 0 H 2
3 | 2 | 0 0 H 0 | 0 2 - - 3 - 3 |
H 2 | 5 = = 6 - 3 - - 3 - - 2 - 3
H | 1 H 0 0 | 1 - 2 0 | 0 3 = 4 |
3 | 0 H 0 0 | 0 0 | 0 | 0 | 0 H 2
| 2 - 4 - - 4 = = 5 = 4 - 3 - 3 |
3 = 3 - - 2 - - 2 - 2 - 2 - 2 - 2