#17X17
2 - 3 0 1 - 2 - 2 - - 2 - 2 - - 2
| 0 H 3 = 5 - 3 - 5 = = 4 - - 1 |
3 = 6 | 0 H 1 | 2 H 0 0 | 0 0 0 |
0 0 H 3 - 4 | 2 H 4 - - 5 - 3 - 4
2 - 5 | 1 | 3 | 3 | 0 0 H 0 | 0 H
| 0 H 2 | 1 H 1 | 2 - 1 H 0 3 = 5
3 = 5 | 4 = 5 - 5 - 4 - 5 - - 1 |
0 1 | 1 | 0 0 0 H 0 H 0 | 0 0 0 |
0 | 3 = 5 - - - 6 = 7 = 6 - 3 - 3
1 | 0 0 | 0 1 0 | 1 | 0 H 0 | 0 |
| 3 - - 4 0 | 0 2 | 3 - 6 = 5 0 |
2 | 0 0 H 0 2 0 | 2 | 1 | 0 H 0 2
| 4 = 2 H 0 | 0 2 | 1 | 4 = 5 0 |
2 | 1 - 5 - 4 0 | 5 = 4 | 2 | 0 2
| | 0 0 | 0 H 0 1 H 0 | 1 H 1 0 |
| 2 - - 4 = 5 - - 4 - 3 - 3 0 0 |
2 - - 2 - 2 - 2 - - 2 - 2 - 2 - 2