#17X17
1 0 0 2 - 2 - 2 - 2 - 2 - - 2 - 2
| 0 0 | 1 - 5 = 5 - 4 - 5 = = 3 |
3 - 1 | 0 0 H 0 H 0 H 0 H 0 0 | |
| 2 - 6 = = 7 - 4 0 H 0 H 0 0 | 2
| | 0 H 0 1 H 0 | 0 5 = 6 - - 4 |
2 | 0 H 0 | 4 = 4 0 | 1 | 0 0 H 2
| 5 = 7 = 6 - 1 | 0 2 | | 2 - 5 |
2 H 0 | 0 H 0 0 | 0 | | 1 | 0 H 2
| 5 = 6 - 5 - - 4 0 | 4 - 5 = 6 |
2 | 0 H 0 | 0 0 H 0 2 H 0 | 0 H 2
| 4 - 6 = 4 - 2 H 0 | 4 = 4 - 4 |
2 H 0 | 0 0 0 | 5 = 6 - 2 - 3 | 2
| 5 = 5 = = 4 | | 0 H 0 0 0 H | |
2 | 2 = 3 0 H | 4 = 7 - - 1 H 1 |
| | 0 0 | 0 H 1 | 0 H 0 0 0 3 - 3
| 2 - - 3 - 4 - 3 - 4 - 1 0 0 0 |
2 - 2 - - 2 - 2 - 2 - 2 - 2 - - 2