#17X17
2 - 2 - - 2 0 2 - - 2 0 0 1 - - 2
| 3 = = 4 | 0 | 0 0 | 0 3 - - 2 |
| | 0 0 H 3 = 5 - 1 | 0 H 0 0 | |
| | 1 - 5 - 2 | 1 - 3 - 7 = 2 | 3
2 | 0 0 | 0 | | 0 0 0 0 H 1 - 3 H
| 4 = = 5 0 | 2 - 4 = = 7 - 2 | 3
| | 0 0 H 0 | 0 0 | 1 0 H 0 | 2 |
| 5 = = 7 = 5 - 2 | | 0 6 = 4 | |
2 H 0 0 | 0 | 0 | 2 | 0 H 0 | | 2
| 5 - - 3 0 | 1 | | 2 - 7 = 4 | |
2 H 0 0 | 0 1 | 1 | 0 0 H 0 | 2 |
| H 1 - 5 = = 4 - 6 = = 6 - 4 | 2
| 4 - 2 | 0 0 0 0 H 0 0 | 0 H 1 |
| | 0 | 4 - 2 - 1 H 2 = 6 = 5 - 3
2 | 0 1 H 1 - - - 4 - 1 | 3 = 3 |
| 2 - - 4 - - 1 0 0 2 = 3 | 0 | 1
2 - - 2 - - 2 - - 3 = 3 - 2 0 1 0