#17X17
0 2 0 1 - 2 - - 3 - 2 - 3 = = 2 0
0 H 1 - 2 - 3 0 | 1 - 4 = 5 - - 3
1 H 0 0 0 0 H 0 | 0 0 | 0 H 0 0 H
| 4 = 3 - - 7 = 4 - - 4 - 4 - 2 H
3 - 2 - - 1 H 1 - 2 0 | 0 0 0 | 3
| 2 = = 3 - 7 = 3 | 0 | 1 - - 2 |
2 - - 3 = 4 H 0 | 2 - 6 = 4 - - 3
0 0 0 0 0 H 3 - 3 - 1 H 0 | 0 0 |
1 - 3 - - 6 - 3 = 4 - 4 0 | 3 - 3
0 0 | 0 0 H 3 = 3 | 2 | 0 1 H 0 |
2 0 | 3 - 5 | 1 | 1 H 2 - - 5 = 4
H 0 3 H 0 H 1 | 2 - 6 - 2 - - 2 |
H 0 H 2 0 H 0 | 0 0 H 1 - - 3 | 2
4 = 5 - - 6 = 7 = = 7 = = 2 H 2 |
0 0 0 0 0 | 0 H 0 0 | 0 0 0 H | 1
1 - - 3 = 4 - 5 = = 4 - 2 - 3 | 0
0 2 = = 3 - 3 = 3 - - 3 = 3 - 2 0