#17X17
2 - 3 0 0 1 0 2 - 2 - 2 - 2 - 1 0
| 0 H 0 0 | 0 | 1 - 4 - 4 - 3 - 2
3 = 7 = = 6 = 6 - 2 H 0 H 0 | 1 |
0 1 | 0 0 | 0 H 0 | 4 = 7 = 3 | 2
1 | 2 - 2 | 0 H 0 | 0 0 | 0 0 | |
| 4 - 2 | 3 = 8 = 5 - - 6 = = 4 |
2 H 1 | | 0 0 H 0 | 0 0 H 0 0 | 2
| 3 | | 4 = = 5 - 4 = = 6 - 2 | |
2 | | 1 | 0 2 - 2 - 1 0 | 1 | | 2
| | 2 - 4 0 | 1 - 4 = = 4 | | 2 |
2 | 0 0 H 0 | 0 0 | 0 0 | | 1 | 2
| 3 - - 7 = 6 - - 4 - 1 | 3 = 4 |
| | 0 0 H 0 H 0 0 | 3 = 4 - 1 | 2
2 | 3 - 5 - 6 - 2 | | 1 - 2 - 3 |
| 1 H 0 | 0 H 0 | 1 | 0 0 0 0 | 2
2 - 5 = 5 = 6 = 4 - 3 - 3 = = 3 |
0 1 - 2 - 3 = 3 - 3 = 3 - 2 - - 2