#17X17
2 - 2 0 1 - 2 - - - - 2 - 2 - 2 0
| 0 | 1 - 2 - - 3 - 5 = 4 - 2 | 1
| 0 5 = = = = 2 | 2 H 0 | 0 | 2 |
2 0 H 0 1 - 2 - 3 H H 0 | 0 3 | 2
| 0 4 - - - - 1 | H 3 - 3 0 H 2 |
| 0 | 1 - 3 - - 2 H 0 0 | 0 2 | |
2 - 5 - 3 | 1 - - 4 - - 4 - - 2 |
0 0 H 0 H 2 - 2 - - - 1 | 0 0 0 |
2 - 5 = 6 - 2 - 3 = 3 - 4 - 4 - 3
| 0 0 0 | 0 0 0 0 0 0 0 | 0 H 0 |
| 3 - - 4 - - 4 = 5 - - 5 = 7 = 5
| H 0 1 | 0 0 | 0 H 0 0 | 0 | 0 H
2 H 0 | 2 - 2 | 0 H 0 0 | 0 4 - 4
| 4 - 3 - 1 | 4 - 6 = = 3 0 H 0 |
1 | 0 0 0 0 1 H 0 | 1 - - - 6 = 4
0 | 1 - 2 - - 5 = 4 - 2 - 1 | 0 |
0 3 = 3 - 3 = = 3 - 2 - 2 - 2 0 1