#17X17
0 3 = 5 - 1 0 0 2 0 1 - 2 - 2 - 2
1 | 0 H 0 0 0 0 H 1 - 2 - 4 - 2 |
| 2 - 6 - 3 - - 5 = 5 - 2 H 0 | 2
| 0 0 H 0 | 0 0 0 0 H 0 | 3 0 | |
2 0 0 4 = 5 - 4 - - 6 = 4 | 0 1 |
| 3 - - 1 | 0 H 0 0 | 1 | 2 - - 3
2 H 0 3 = 7 = 5 - 1 | | | 0 0 0 |
| H 0 | 0 H 1 - 4 - 2 | 2 - 3 = 4
| 3 - 3 - 4 - 1 H 1 - 4 - 4 - 2 |
2 - 2 - 4 = 5 - 5 - 1 | 0 H 0 | 2
0 0 0 0 | 0 H 0 | 3 - 5 = 4 0 | |
2 - - 3 | 0 H 0 1 H 0 | 1 - - 2 |
| 2 0 H 5 = 7 - - 6 = 6 - 3 - - 4
| H 0 3 H 1 H 0 0 | 0 H 0 | 0 0 H
2 H 0 | 2 | 4 = = 4 - 6 = 6 - 1 H
| 3 - 3 - 3 - 2 - - 1 | 0 H 0 0 2
2 - 2 - 3 = 3 - 2 - - 2 0 3 - 1 0