#17X17
0 2 - 3 = = = = 3 - 2 - 2 - 1 0 0
1 | 1 - 2 - 2 - - 3 = 5 - 3 - - 2
| 3 - 3 = 3 - 2 - - 1 H 0 | 0 0 |
2 | 1 - 3 - 4 - - 3 - 6 = 6 - 2 |
| 5 = 2 | 0 H 0 0 | 0 | 0 H 0 | 3
2 H 1 - 5 = 6 = = 5 0 | 0 6 = 4 H
| 6 = 3 | 0 0 0 0 H 0 3 0 H 0 | 3
| H 0 | | 1 - 3 = 4 0 H 0 3 - 3 |
2 H 0 | 3 = 3 - 3 - - 5 - - 1 | |
| 5 - 4 - - - 1 | 0 1 | 2 = = 5 |
2 H 0 | 0 1 0 0 | 0 | 2 - 2 0 H |
| 4 = 4 0 | 2 = 5 - 5 - 2 | 0 H 3
3 - 1 | 0 | 0 0 | 0 H 0 | 3 - 5 H
| 1 - 5 = 6 - - 5 = 7 = 5 | 0 H 3
| 0 0 | 0 H 0 0 | 0 | 0 H 3 = 5 |
2 - - 3 - 5 = 2 | 0 2 - 4 - 1 | 1
0 2 = = 3 - 2 - 2 0 0 1 - 2 - 2 0