#17X17
2 - - 2 0 0 1 - - 2 - 3 - 3 - 2 0
| 1 0 | 0 3 = = 3 - 1 | 1 | 0 | 0
2 | 0 | 0 | 1 - - - - 2 | 1 0 | 1
| 4 - 5 = 5 - 4 - 3 - - 4 = = 5 |
| H 0 | 1 | 0 H 0 | 1 - - - 3 H 2
2 H 0 2 | | 0 H 0 4 - 3 - 1 H H |
| 3 0 | | 5 = 5 0 H 0 | 0 0 H 2 |
2 | 0 1 | H 0 | 0 5 = 6 - - 4 - 4
| 2 - - 2 H 0 | 0 | 0 H 1 - - 2 H
2 0 1 - - 7 = 5 0 | 0 H 0 0 0 | 3
| 3 - - 2 H 0 H 0 3 = 7 = 5 - 3 |
| H 0 0 | 4 = 7 = = 3 | 0 H 0 | 2
3 H 0 0 | 0 0 | 0 0 | | 0 H 0 | |
H 5 = = 4 - - 3 - 1 | 4 - 5 = 4 |
2 | 0 3 = 3 - - - - 2 H 0 0 0 | 3
0 | 0 | 1 - 2 - 2 - - 3 0 0 0 1 H
0 2 - 3 - 3 = 3 - - 2 - - 2 - - 3