#9X9
1 0 2 - - 2 0 0 1
| 1 | 0 0 | 0 0 |
2 | 2 - 1 | 2 = 4
| 3 - 5 = 7 = 3 |
2 | 0 H 0 H 0 | 2
| 3 = 6 - 4 - 3 |
3 - 1 | 0 0 0 | 2
| 0 0 | 1 - - 2 |
2 - - 3 - - 2 - 2