#9X9
2 - 2 - - - 2 0 1
| 3 = = 3 0 | 0 |
2 | 1 0 | 0 2 0 |
| 2 | 0 | 0 | 0 2
| | 3 - 4 - 3 0 |
2 | | 0 | 0 | 0 |
| | 1 0 | 0 2 - 3
| 1 0 0 2 - - 1 |
2 - 2 - - - 2 - 2