#9X9
2 - 2 0 1 - 2 - 2
| 0 | 2 - - - 1 |
| 0 1 | 0 1 - - 3
3 - - 3 - - - 1 |
| 0 0 0 0 0 0 0 |
| 1 - - - 3 - - 3
3 - - 1 0 | 1 0 |
| 1 - - - 2 | 0 |
3 = 3 - 2 - 3 - 2