#9X9
0 0 1 - 2 0 2 0 1
1 - - 3 | 0 H 0 |
0 0 0 H 4 = 6 = 4
2 - - 4 | 2 - 1 |
| 0 0 | 1 | 0 0 |
| 1 - 3 - 3 - - 3
3 - 2 - - - - 1 |
| 2 = = 3 - 2 - 2
2 - - 2 - 2 - 1 0