#9X9
0 2 - 3 0 0 2 - 3
1 | 0 H 0 0 | 0 H
| 4 = 7 = = 6 = 6
| | 0 | 0 0 | 0 H
3 | 1 | 1 - 3 - 4
H 2 | 3 - - - 2 |
3 | 2 | 0 1 0 | 1
| 1 | 1 0 | 0 | 0
2 - 3 - - 3 - 2 0