#9X9
2 - 2 0 1 - 3 - 2
| 0 | 1 - 3 | 1 |
| 0 3 = 3 H 1 | 2
2 0 0 1 | 5 - 2 |
| 0 0 | 2 H 0 0 |
| 1 - 3 | 4 - - 3
3 - 1 | 1 | 1 0 |
| 1 - 4 = 3 | 0 |
2 - 2 - 2 - 3 - 2