#9X9
0 1 - - 2 - 4 - 2
2 - - 2 - 1 H 0 |
| 1 - - 3 - 5 = 4
3 - - 1 | 0 0 0 |
| 2 - - 5 = = 2 |
| | 0 0 | 2 = = 4
2 | 3 = 5 - - 1 |
| 1 | 0 | 1 - - 2
2 - 2 0 2 - - 1 0