#9X9
2 - 2 - 3 0 3 - 2
| 1 - 2 H 1 H 2 |
| 0 0 | 2 | 2 H 2
2 0 0 4 = 6 - 3 |
| 0 0 | 0 H 0 0 |
| 2 - 6 = 6 - - 3
2 | 0 H 0 | 0 0 |
| 3 = 5 - 4 = 2 |
2 - 2 - 2 - 2 - 2