#9X9
0 1 - 2 - 3 - - 2
1 - 4 - 2 | 0 0 |
0 0 H 0 | 2 - 1 |
2 - 7 = 4 - 5 = 4
| 0 H 0 0 0 H 0 |
2 0 H 1 - - 5 - 3
| 0 3 - 1 0 | 1 |
| 0 0 1 - - 2 | 1
2 - 2 - - 2 - 2 0