#9X9
1 - 2 - 2 - 2 0 1
0 2 - 3 - 3 | 0 |
2 | 0 | 0 H 3 = 4
H 1 0 | 0 H 0 0 |
3 - - 6 = 7 = = 5
0 0 0 H 0 | 0 1 H
2 - 3 H 0 | 0 | 3
| 0 H 3 - 3 - 2 |
3 = 5 - 3 = 3 - 2