#9X9
1 0 1 0 2 - 4 - 2
| 0 | 0 | 1 H 0 |
| 0 | 0 1 | 3 0 |
4 = 4 - - 3 | 0 3
| 3 = = 3 | | 0 H
2 | 1 0 | | 2 - 5
| | | 0 2 | 0 0 H
| 1 | 0 | 1 0 0 H
2 - 3 - 3 - 2 - 3