#9X9
0 3 = = 3 - 2 0 1
1 | 2 - - 1 | 0 |
| 2 | 0 0 0 | 0 |
2 | 5 = 4 - 6 = 4
| 1 H 0 | 0 H 1 |
4 = 7 - 4 = 5 | 2
| 0 H 0 0 0 | 2 |
| 0 H 1 - - 2 | 1
2 - 4 - 2 - - 2 0