#9X9
2 - 4 - 2 - - 1 0
| 0 H 3 = 3 - - 2
3 = 5 | 3 - - 1 |
0 1 | 1 H 3 - - 3
1 | 3 = 5 H 1 0 |
| 3 - 2 | 2 | 0 |
2 | 0 | 2 - 6 = 3
| 1 0 | 0 0 H 0 0
2 - - 3 - - 4 - 1