#9X9
3 - - 2 - - 2 0 1
H 0 1 - - 2 | 0 |
3 - - 2 0 | | 0 |
0 0 0 | 0 | 3 = 4
0 1 - 5 = 6 - 1 |
2 - 3 | 0 H 0 0 |
| 0 H | 0 3 - - 3
| 0 H 2 - - 1 0 |
3 = 5 - - 2 - - 2