#9X9
0 3 - 3 - - 2 0 1
0 H 0 | 1 0 | 0 |
1 H 1 | | 0 5 = 4
| 2 | 1 | 0 H 0 |
2 - 5 - 4 - 6 = 4
0 0 H 0 | 1 | 1 |
2 - 5 0 | | 1 | |
| 0 H 0 1 | 0 | 1
3 = 5 - - 3 - 2 0