#9X9
0 2 - - 3 - - 1 0
1 | 0 0 | 0 3 = 4
| 5 = 4 | 0 | 0 H
3 H 1 H 2 - 4 - 4
H 3 | 3 - 1 | 1 |
3 | 4 = 4 - 2 | 2
| | | 0 | 1 - 3 |
| 1 | 0 | 0 0 | 1
2 - 2 0 2 - - 2 0