#9X9
2 - - 2 0 1 0 1 0
| 0 0 | 0 | 0 | 1
3 - 1 | 0 | 0 | |
| 2 = 7 = 6 = 4 |
3 - 1 H 0 | 1 | 2
| 3 = 7 - 3 | 1 |
| | 0 H 0 | 2 - 3
1 | 0 H 0 2 - 1 |
0 2 - 4 - - 2 - 2