#9X9
1 - 3 0 2 - 1 0 0
0 0 H 0 | 2 - - 3
2 - 7 = 4 | 1 0 H
| 0 H 0 | 3 | 0 H
4 = 7 - 3 H 4 = 6
| 0 H 0 | 3 | 0 H
| 0 4 = 4 | 4 = 5
2 - - 1 | 1 | 0 |
0 1 - - 3 - 2 0 1