#13X13
3 - - 2 - 2 0 0 2 - 3 0 1
H 3 = = 4 | 0 0 | 0 H 1 |
3 | 0 0 H 5 = = 6 = 4 | |
| 4 = = 6 H 0 0 | 0 0 | 3
3 | 0 0 H 5 - 1 | 1 - 3 H
H 4 - - 4 H 1 - 4 - 1 | H
3 H 0 0 | 3 - 2 | 0 0 | 3
| H 3 - 5 = 2 | 4 - - 2 |
| 3 H 0 | 1 - 3 H 0 0 0 |
3 | H 0 | 0 0 | 5 = 4 = 4
H | 4 = 4 - - 4 | 0 0 0 |
H 2 - 1 0 0 0 H 2 - - 1 |
3 - 2 - 2 - - 3 0 0 1 - 2