#13X13
0 1 - 3 = 3 - - 2 - 2 0 2
2 - 4 = 4 - - 3 - 1 | 0 H
| 2 | 2 | 0 0 | 0 0 | 0 H
3 H 2 H | 3 = 7 = = 6 = 5
H 3 | H 2 | 0 H 0 0 | 1 |
H | | 3 | | 0 H 0 0 | | 3
3 | 1 | | 3 - 7 = = 3 | H
| | 0 | 1 | 0 H 0 0 0 | 3
| 4 - 5 = 5 0 H 2 - - 3 |
3 H 0 | 0 H 0 2 | 0 0 | 3
H H 0 | 0 H 0 0 | 1 - 2 H
H 4 = 4 - 4 - - 3 - 2 - 3
3 - - - 3 = = 3 - 2 - 1 0