#13X13
2 - 3 0 2 - 2 - 2 - - 1 0
| 0 H 0 | 1 - 2 - 5 = = 3
3 = 8 = 7 = 4 = 3 H 0 0 |
0 0 H 0 H 1 - 2 | 3 - - 3
2 - 6 - 7 = 4 | 3 - - 1 |
| 0 H 1 H 0 H 3 | 3 - - 3
| 0 2 | 3 - 3 H 2 H 1 0 |
3 - - 5 - 2 - 3 | 3 | 0 |
| 0 1 H 1 - 5 = 5 | | 0 3
2 0 | 3 - 1 H 0 H | 2 0 H
| 0 | 0 1 - 4 - 4 | | 0 3
2 - 3 - - 2 - 1 | 1 | 0 |
0 1 - - 2 - 2 - 3 - 3 - 2