#13X13
0 0 1 - 3 = = 3 - 2 - - 2
1 - - 3 = = 5 = 3 - 1 0 |
0 0 0 0 0 0 | 3 = 4 - - 3
2 - 4 - 4 - 3 | 2 | 1 0 |
| 0 H 0 H 0 | 1 H 1 | 0 |
3 = 8 = 5 0 | 0 5 = 6 - 4
0 0 H 0 | 0 1 0 | 0 H 0 H
2 - 5 - 4 - - - 3 - 7 = 5
| 0 | 1 | 1 - 3 = 3 H 0 |
| 0 1 | 5 = 5 - 1 | 3 - 3
3 - - 2 H 1 H 0 0 | 0 0 |
| 0 1 - 3 | 3 - - 3 - - 2
2 - - 2 - 3 - 2 - - 1 0 0