#13X13
0 2 - 4 - - 2 0 2 - 2 0 1
1 | 0 H 0 0 | 0 | 0 | 0 |
| 3 = 6 - 1 | 0 | 0 4 = 5
| 0 0 | 1 - 5 = 5 0 | 0 H
2 - - 6 = 3 | 1 H 0 2 - 5
0 0 0 H 0 | 2 | 3 - - 1 H
2 - - 7 = 3 | 4 - 3 0 0 H
| 0 0 H 1 - 2 H 2 H 3 = 6
4 = = 6 - 2 - 3 H 3 | 1 H
| 0 0 | 2 - 3 - 4 | 2 | 3
| 0 2 | | 0 | 2 | 1 | 3 |
1 0 H 1 | 0 1 H 3 = 3 H 1
0 0 3 - 3 - - 4 - 2 - 3 0