#13X13
0 1 - - 3 = = 3 - 2 0 0 1
2 - 3 = = 4 - - 1 | 0 0 |
| 1 - - 3 | 3 = = 6 = = 4
2 - 3 0 H | | 0 1 | 1 0 |
0 0 H 0 H 1 | 0 | 1 | 0 |
3 = 7 = 7 - 4 - 5 - 5 - 3
| 0 | 0 H 0 | 0 H 0 H 0 |
1 0 3 - 4 0 | 0 6 = 6 = 4
0 0 | 2 | 0 3 0 H 0 0 0 |
0 0 1 H 1 0 H 0 H 1 - - 3
3 - - 4 - - 4 - 4 - - 1 |
H 1 - - - 2 - 2 - - 3 = 3
3 - 3 = 3 - 2 - 2 - - 1 0