#13X13
0 0 2 = = 3 - 2 - 3 - 1 0
1 - - 4 - - 5 = 2 | 1 - 2
0 0 0 H 0 0 H 2 = 6 - 3 |
2 - - 6 = = 5 - 3 H 0 H |
| 0 2 | 0 0 0 0 H H 0 H 2
| 0 H 5 = 6 = 3 H 5 = 4 |
3 - 3 H 0 H 0 | 3 | 3 = 5
| 3 - 5 - 4 - 2 | 3 | 0 H
2 H 0 | 0 0 0 0 1 H 1 0 H
| H 0 | 1 - 4 - - 5 - - 4
| 5 = 6 - 1 H 0 0 | 0 0 |
1 | 0 H 1 - 5 = = 4 - 1 |
0 2 - 4 - 3 = 3 - - 2 - 2