#13X13
3 - - 3 = = 3 - 2 - 2 0 1
H 0 3 = 5 = = 4 - 2 | 0 |
H 0 | 1 | 0 0 | 1 | | 0 |
3 - 4 | | 3 = 5 | | 4 = 5
0 0 H | 1 | 0 H | 1 | 0 H
2 - 5 | 0 | 0 H 2 - 4 - 5
| 0 H 2 - 3 - 4 - 1 | 0 H
3 = 7 - 2 - 2 - 3 - 6 = 5
0 0 H 0 0 0 0 0 | 0 H 0 |
2 - 7 = = 4 = = 7 = 7 = 5
| 0 H 0 2 - 1 0 H 0 | 0 H
| 0 H 0 | 1 - - 5 = 4 - 3
3 = 5 - 3 - 2 - - 2 - 1 0