#13X13
0 1 0 1 0 1 0 2 = 5 - 2 0
1 | 0 | 0 | 0 0 0 H 1 | 1
| 4 = 7 = 6 = 5 - 3 | 2 |
| | 1 H 0 | 0 H 3 - 4 | 2
2 | | 3 - 4 - 5 H 0 H | |
| 1 | 0 0 | 0 H 2 0 H 1 |
3 - 3 - - 5 = 7 - - 7 = 4
| 3 = 2 0 | 0 H 0 0 H 1 |
| | 3 = = 5 - 7 = 3 H | 2
2 | | 0 0 | 0 H 0 | 2 | |
| 2 | 2 - 6 = 7 = 7 = 4 |
1 | 1 | 0 H 0 | 0 H 0 | 1
0 2 - 4 = 4 0 2 - 4 - 2 0