#13X13
3 - - - 2 - 2 - 2 - - 1 0
H 0 2 - - 3 - 4 = = 4 - 3
3 0 | 0 0 | 1 | 0 1 | 0 H
| 0 3 - 1 | | | 0 | 1 0 H
| 0 | 1 - 2 | 2 - 5 = = 5
3 - 3 - 4 = 7 = 3 | 1 0 |
| 0 0 0 | 0 H 0 | 1 | 0 |
| 2 = = 5 = 8 = 5 - 5 - 3
3 - 2 - - 1 H 0 | 0 H 0 |
| 0 0 0 0 0 H 0 4 = 8 = 4
| 3 - 2 - - 3 0 | 0 H 0 |
1 H 1 - - 3 = = 4 - 3 0 |
0 3 - - 3 = = 3 - 2 - - 2