#13X13
3 - 2 0 1 - - 2 - 3 0 1 0
H 1 | 0 0 0 0 0 0 H 0 | 1
H | 4 = = 5 = 5 - 6 = 5 |
3 | | 0 0 | 1 H 0 | 0 H 3
| | 2 - 1 | | 5 = 5 = 5 H
2 | 0 1 - 2 | | 3 = 2 | 3
| 4 - - 2 - 2 | | 2 = 4 |
2 H 1 - - - - 2 | 0 0 | 2
| 4 - 5 = 5 - - 5 = = 3 |
| | 0 H 0 H 0 0 | 1 - - 3
| 4 = 5 - 7 = = 6 = 4 0 |
1 | 0 0 0 H 0 0 | 0 H 0 |
0 1 0 1 - 3 0 0 2 - 4 - 2