#13X13
0 2 = = 3 - 3 - 3 - 2 - 2
2 - - 3 - 3 | 2 | 2 - 3 |
| 0 0 | 0 H 1 H 1 | 0 H 3
| 2 = 5 = 6 = 5 - 5 = 4 H
3 = 3 - 2 - - - 1 | 0 0 H
0 2 = 4 - - 3 = = 5 = = 5
0 0 0 | 0 2 = 3 - - 2 0 |
2 - - 4 - - 2 - 1 0 | 0 |
| 0 0 | 0 2 = 5 = = 6 - 3
| 1 - 3 - - 1 | 1 0 H 0 |
3 - 2 - 3 = = 3 | 0 H 0 |
| 1 - 2 - 3 = = 5 = 6 = 3
3 = 3 - 3 = 3 - - 2 - 1 0