#13X13
3 - 2 - - 3 = 3 - 2 - - 2
H 2 - 2 0 0 1 - 4 - 2 0 |
H | 0 | 0 0 0 0 H 0 | 0 |
3 | 0 | 0 1 - - 5 = 5 = 5
| | 0 5 = = = 3 - - - 1 H
2 | 0 H 1 - 2 - - 4 - - 5
| 1 0 H 0 0 0 0 0 H 0 1 H
2 - - 5 = = = = 2 H 0 | 3
0 1 - - - 2 - - - 6 - 3 |
2 - 5 = 4 - - 2 0 H 0 | |
| 0 H 1 | 0 0 | 0 H 0 | 3
| 0 2 | 2 - 1 | 0 4 = 3 H
2 - - 2 0 1 - 3 - - 2 - 3