#13X13
1 - - 2 0 3 = 3 - - 2 - 2
0 0 1 | 0 | 2 - 3 = = 3 |
0 0 | 3 0 | | 1 - - 3 | 3
2 - 4 H 0 1 | 0 0 0 H 1 H
| 0 H 4 - - 3 - 5 = 7 - 4
| 0 4 | 2 - - 1 H 1 H 0 |
2 0 H 2 | 0 2 - 3 | 4 = 4
| 0 3 | | 0 | 2 = 6 = 4 |
2 0 | | 4 - 3 - 1 | 0 H 2
| 0 2 | H 1 - 2 - 5 - 4 |
| 0 | 1 H 0 0 0 0 H 0 | 2
2 - 3 - 5 = 3 - - 5 = 3 |
0 1 - 3 = 3 - - 3 = 3 - 2