#13X13
1 - - 2 0 1 0 2 - - 3 - 2
0 0 0 | 0 | 0 | 1 0 | 0 |
0 2 = 7 = 7 = 4 | 0 | 0 3
3 - 1 H 1 H 0 | 4 - 2 0 H
H 3 - 3 | 3 - 2 H 1 - - 4
3 H 1 - 4 - 4 - 6 = = 3 |
| 3 - 1 | 0 H 0 | 0 0 | 3
2 - - - 4 = 7 = 5 - 2 | H
0 0 2 - - 1 | 2 | 2 | 2 H
0 0 | 1 - - 2 H 2 H 1 | 3
1 - 5 - 2 - - 3 | 3 - 2 |
0 0 H 1 - - 3 = 3 0 0 0 |
1 - 4 - - 3 = 3 - 2 - - 2