#13X13
0 2 = 3 - 2 - - 2 0 1 - 2
2 - 5 = 5 - - 1 | 0 0 0 |
| 0 H 0 H 0 1 - 4 - - 2 |
3 = 7 - 5 - - 1 | 0 1 | |
0 0 H 0 | 3 - - 4 0 | | 2
0 0 H 0 | H 0 0 H 0 | 2 |
1 - 6 = 5 H 3 - 7 = 4 | 2
0 1 | 0 H 4 H 0 H 0 | 1 |
1 | 2 - 5 H 2 0 H 0 | 0 |
| | 0 0 H 4 = = 7 - 4 - 3
| 2 - - 5 - 1 0 H 1 | 0 |
| 0 0 0 | 1 - - 3 | 1 0 |
2 - 2 - 3 - - 2 - 3 - - 2