#13X13
3 - 3 = 3 - - 2 0 0 2 - 2
H 4 = 5 = 4 0 | 0 1 | 0 |
3 H 0 | 0 H 0 | 0 | | 1 |
| 5 - 4 - 4 - 2 0 | 1 | 3
3 H 0 | 1 - 5 = = 5 - 2 H
H 3 0 | 0 0 H 0 1 | 0 0 H
H | 0 3 = = 5 0 | 5 = = 6
3 | 0 0 0 0 | 0 | H 0 1 H
| 3 - - 3 = 4 - 2 H 0 | 3
3 | 2 - - 3 - 5 = 6 - 4 |
H 1 | 0 0 | 0 H 0 | 0 H 3
H 0 | 1 - 4 = 6 = 5 = 4 H
3 - 2 0 1 - 3 = 3 - 2 - 3