#13X13
2 - 4 - - 3 = 3 - 2 - 1 0
| 0 H 1 - - 2 - 2 - 3 - 3
4 = 5 - - 2 - - - 1 | 0 H
| 1 - - 5 = = 5 - - 4 = 5
3 - - 3 H 1 0 H 3 = = 2 |
| 0 0 H 3 | 0 4 | 0 0 0 |
2 - 3 H | 2 0 H 3 - 2 - 4
0 0 H 2 | | 0 H | 0 0 0 H
0 0 3 - 2 | 0 3 | 1 - - 4
3 - - 3 = 4 0 | 2 - - 1 |
H 0 0 0 0 | 0 2 - - 4 = 4
3 - 2 - 1 | 0 0 0 0 | 0 |
0 1 - 2 - 3 - - 2 - 2 0 1