#13X13
3 - 3 = = 3 - 3 = 3 - - 2
H 1 - 4 = = 5 - 3 - - 2 |
H 0 0 | 0 0 H 0 | 0 0 | 2
3 - 3 | 4 = 7 = 7 = 3 | |
0 0 H 1 H 0 | 0 H 0 | 1 |
1 - 6 - 6 - 5 = 7 - 4 - 4
0 0 H 0 H 0 | 0 H 0 | 0 H
2 - 6 = 8 = 7 = 8 = 7 = 5
| 0 | 0 H 0 H 0 H 0 H 0 |
| 0 3 = 7 = 8 = 6 - 5 - 3
2 - - 1 | 0 H 0 | 0 | 0 |
0 1 - - 3 - 4 - 2 0 | 0 1
1 - - 2 - 3 = 3 - - 2 0 0