#13X13
2 - 2 - 2 - 2 - - 2 - 1 0
| 1 - 4 - 2 0 1 - - 5 = 3
| 0 0 H 0 | 2 - - 1 H 0 |
2 - - 7 = 3 | 0 4 = 6 - 4
0 0 0 H 0 0 | 0 H 0 | 0 H
2 - - 5 = = 7 = 7 - 6 = 5
| 1 - - - 2 H 0 H 1 H 1 |
2 - 5 = 3 | H 1 H | 3 | 3
0 0 H 0 | | 3 | H 2 | 3 H
2 - 6 - 2 | | 2 H | | H H
| 0 H 0 0 | 1 | 2 | 1 H 3
3 = 5 - - 3 - 3 - 3 - 3 |
0 1 - - 3 = 3 - 3 = 3 - 2