#9X9
2 - - 2 0 2 - 1 0
| 0 0 | 0 | 2 - 2
3 - 3 | 0 | | 1 |
| 1 H 5 = 4 | | |
2 | 3 H 0 | 1 | 2
| | | 5 = 5 - 2 |
| 2 | | 0 | 1 - 3
1 | 1 | 0 | 0 0 |
0 2 - 2 0 2 - - 2