#9X9
0 0 1 - - 3 - - 2
3 = = 2 0 | 0 0 |
| 2 = = = 5 - 1 |
3 - 2 - 1 | 2 = 5
| 2 = 5 = 4 - 1 H
3 - 2 | 1 - 3 = 5
| 0 | 3 - - - 1 |
| 0 1 | 0 1 - - 2
2 - - 3 - - 1 0 0