#9X9
2 - 3 0 2 - 2 - 2
| 0 H 0 | 0 0 0 |
4 = 6 = 4 - - 2 |
| 3 = 4 - - 2 | |
2 | 0 | 0 0 | | 2
| | 0 2 - 1 | 1 |
| 2 - - 5 = 6 = 5
1 0 0 0 H 0 | 0 H
0 1 - - 3 0 2 - 3