#9X9
0 2 - 2 - 2 - - 2
0 | 2 - 2 - - 2 |
1 | | 1 - - 3 | 2
| 1 | 0 0 0 H 1 |
3 - 5 - 2 - 6 = 5
| 1 H 0 0 0 | 0 H
3 | 3 - - 1 | 0 H
H 3 = = 3 - 3 - 3
3 - - 2 - 2 - 1 0