#9X9
0 1 - 2 - 3 - - 2
2 - 5 = 3 | 1 0 |
| 0 H 0 | 2 | 0 3
4 = 5 - 2 | 3 0 H
| 1 - 4 - 2 H 0 H
| 0 0 H 1 - 5 - 5
3 - - 5 = 2 | 0 H
| 0 1 - 2 - 4 = 4
2 - - 2 - 2 - 1 0