#9X9
0 0 1 - 2 0 2 - 3
2 - - 1 | 0 | 0 H
| 1 - - 4 = 5 = 5
3 - 2 - - 2 - 1 |
| 1 - - 2 0 0 0 |
3 - - 1 | 0 1 - 3
| 0 1 - 5 - - 1 |
| 0 0 0 H 0 0 0 |
2 - 2 - 4 - 2 - 2