#9X9
0 1 - 3 - 2 - - 2
1 - 3 | 3 - 2 0 |
0 0 H 1 H 0 | 0 |
3 - 7 = 7 = 7 = 4
H 0 H 0 | 0 H 0 |
H 0 5 - 4 - 6 - 3
3 0 H 1 | 0 H 0 |
| 0 2 | 3 = 6 = 3
2 - - 3 - 2 - 1 0