#9X9
2 - 2 - - 2 - - 2
| 1 - - 3 = 3 0 |
2 - 4 = = 2 | 0 |
0 0 | 0 1 - 6 = 4
0 0 3 = = 2 H 0 |
3 - - - 1 0 H 0 |
H 1 - 4 = = 8 = 4
H 0 0 | 0 0 H 0 |
3 - - 2 0 0 3 - 2