#9X9
0 2 = 3 - 3 - 1 0
2 - 3 - 1 | 1 - 2
| 0 | 0 0 | 0 0 |
2 0 | 2 = 5 = = 4
| 0 2 - 3 = = 2 |
3 - - 4 = = 4 - 4
| 0 0 | 0 0 | 0 H
2 - 1 | 1 - 4 = 4
0 1 - 3 - 2 - 1 0