#9X9
0 1 - 3 - - 4 - 2
2 - 2 | 0 0 H 0 |
| 0 | | 1 - 6 = 5
| 0 1 | 0 0 | 0 H
3 - - 3 - 1 | 0 H
| 1 - - - - 5 = 6
2 - 4 - 1 0 | 0 H
0 0 H 1 - - 3 - 3
1 - 4 - - 2 - 1 0