#17X17
3 = 3 - 3 = 3 - 2 - 2 - 2 - - 1 0
| 2 - 4 - 5 = 3 - 1 0 3 = 5 - - 2
2 | 0 H 0 H 0 0 0 0 0 | 0 H 0 1 |
| 1 0 H 0 4 = = 3 - 2 | 0 H 0 | 3
2 - - 7 = = = 3 - 3 | 4 - 5 - 2 H
0 1 0 H 2 = 5 = 2 H 1 H 0 | 0 0 H
1 | 0 4 - 2 | 0 0 3 - 3 0 | 2 = 5
| 3 0 | 0 | | 2 - - 5 = = 5 - 3 |
2 H 0 | 0 1 | | 0 1 H 0 0 | 0 H 2
| H 0 5 = = 3 | 0 | 4 - - 6 = 4 |
| 3 0 H 0 3 = 5 = 4 | 2 0 H 1 - 3
2 | 0 H 0 | 0 0 0 | 1 H 0 H 0 0 |
| 2 - 4 0 | 1 - - 4 - 7 = 7 = = 5
2 - 3 | 0 4 - 2 0 | 0 H 0 | 0 1 H
0 0 H 1 0 H 0 | 0 | 0 H 0 | 0 | 3
1 - 4 - - 5 = 5 = 5 = 5 - 3 - 2 |
0 1 - - 3 = = = 3 - 3 = 3 - 2 - 2