#17X17
1 0 1 0 0 1 - 3 = 3 - - 2 - - 2 0
| 0 | 0 4 = 5 = 5 - - 3 - - 2 | 2
| 0 | 0 H 0 | 0 H 0 0 | 1 0 | 2 H
3 = 7 = 7 - 4 - 6 = = 3 | 0 1 | 3
0 0 H 0 H 0 | 1 | 1 - - 5 = = 5 |
2 - 4 - 7 = 3 | | 0 0 0 | 0 0 H 3
| 3 = 2 H 0 0 | 4 = 5 = 6 - - 5 H
| | 2 - 5 - - 4 | 1 | 0 H 1 0 H 3
2 | | 0 | 0 0 H 1 | | 0 H | 0 3 |
| | 1 0 | 0 0 H 0 | 5 = 5 | 0 | 2
| 2 - - 6 = = 7 = 3 H 0 | 2 - 2 |
2 - 1 0 H 0 0 | 2 = 7 - 4 - 5 = 4
0 1 - - 5 - - 3 - 1 H 0 | 0 H 0 |
2 - 3 0 | 3 - - 2 - 6 = 7 = 7 = 4
| 0 H 0 1 H 0 0 0 0 | 0 H 0 | 0 |
3 = 5 - - 5 = 3 - - 3 - 3 0 | 0 |
0 1 - - 2 - 3 = = 3 - 2 - - 2 0 1