#17X17
3 - 3 = = = 3 - - 2 - 2 - 2 - 1 0
H 3 = = 3 - - 2 - - - - 1 0 0 0 0
3 | 1 - - 2 - - 3 = 5 = = 4 - - 3
| 3 - 3 - - 5 = = 4 | 1 0 | 0 1 H
3 | 0 | 0 1 H 0 0 H | | 0 | 0 | 3
H 2 0 | 0 | H 3 - 4 | 4 - 6 = 4 |
3 | 0 3 - 3 H H 0 | 1 H 0 H 0 | 2
| 2 0 | 0 | H 4 = 4 - 3 0 H 0 1 |
3 | 0 2 0 | 4 = 5 = 3 - - 7 = = 4
H 3 0 | 0 | 0 0 | 0 0 0 0 H 0 0 |
3 H 0 | 0 3 = = 7 = = 5 = 7 - - 3
| 5 = 7 = = = 3 H 1 0 | 0 H 0 1 |
2 | 0 H 2 = 3 | H | 0 1 0 H 0 | 3
| 1 0 H 0 0 | | 3 | 1 - - 4 - 4 H
2 - - 4 - - 2 | | | 0 0 0 0 0 H 3
0 0 0 0 1 - - 2 | 2 - - 3 = = 4 |
0 1 - 3 = 3 - - 2 0 1 - - - 2 - 2