#17X17
3 - 3 = 3 - - - 2 - - - 2 - 1 0 0
H 3 - 4 = = 4 - - 2 - 3 = 4 - - 3
3 H 1 | 0 1 | 0 0 0 0 0 0 | 0 0 H
| 2 | 1 0 | 2 - 3 = 5 - - 3 - 1 H
2 - 5 = = 4 - - - 1 H 2 = = 5 - 5
0 0 | 0 3 - - 2 - - 5 - - 1 H 0 H
0 0 2 0 H 0 0 0 0 0 | 0 1 - 6 = 6
1 0 | 0 H 1 - - 3 = 7 = = 2 | 0 H
| 0 5 = 6 - - 5 = 2 H 3 - - 4 - 5
| 0 H 0 | 0 0 H 1 - 3 H 1 0 | 0 H
2 - 6 - 4 = = 8 = 5 = 4 | 0 5 = 5
0 0 H 0 0 0 0 H 0 | 0 0 | 0 H 0 |
2 - 4 - - 4 = 7 - 4 - - 3 - 6 - 3
| 2 = 3 0 | 0 H 0 | 3 - - 1 H 0 |
| 0 0 | 0 | 0 H 0 1 H 1 - - 6 = 4
3 = = 5 = 4 - 4 - - 4 - - 1 | 0 |
0 1 - - 2 - - - - 2 - 2 - - 2 0 1