#17X17
0 1 - 3 = = 3 - - 3 = = 3 - 3 = 3
2 - 3 - 3 - - 5 = = 4 - - 5 = 3 |
| 1 | 1 | 0 0 H 0 0 | 0 1 H 0 | |
| | 1 | | 0 0 H 0 0 | 0 | 2 0 | 2
2 | 0 | 3 = = 7 = = 6 = 6 - - 3 |
| | 0 2 - 2 0 | 0 1 | 1 H 0 1 | 2
| 3 = = 4 | 0 | 0 | 3 | H 0 | 1 |
2 - 3 0 H 4 = 5 - 4 H | 4 - 6 = 4
0 0 H 0 H | 1 | 0 H 2 | | 0 H 0 |
3 - 5 - 5 | | 5 = 6 - 3 | 0 H 0 |
H 1 | 0 H | 2 H 0 | 0 | 3 = 7 - 3
3 | 1 0 H 1 | 2 0 | 0 3 = 2 H 0 |
| 4 = = 8 = 7 = = 5 - - 1 0 H 0 |
| | 0 0 H 0 H 0 0 | 2 = = = 7 = 5
3 | 1 - 3 0 H 0 1 | 0 0 0 0 | 0 H
H 2 - 1 0 0 2 0 | 2 - 2 - - 3 - 3
3 - 2 - 2 - - - 3 - 2 - - 2 - 1 0