#17X17
0 1 0 2 - 3 0 1 0 0 1 - 3 = 3 - 2
1 | 0 | 0 H 0 | 3 = = 4 - 2 - 2 |
| 3 = 7 = 7 = 3 | 0 1 | 2 - 3 | 2
| 0 0 H 0 | 0 0 | 0 | 1 | 0 H | |
2 - - 6 - 5 - - 5 - 5 - 2 0 H 1 |
0 0 0 H 0 H 0 0 H 0 H 2 = = 5 - 3
0 0 0 H 0 H 1 - 5 = 7 - 2 - - 1 |
1 - - 5 = 5 - 2 - 1 H 2 - 5 = = 4
0 1 - - 2 - 3 = 3 - 3 | 0 H 0 0 |
2 - 5 = = 3 - 2 - 3 = 7 = 6 - - 4
| 1 H 0 1 - 3 - 4 - 1 H 0 | 0 0 H
3 | 3 - - 1 | 0 H 0 0 H 0 | 0 0 H
H 3 - - 4 - 5 = 7 - - 6 - 5 = = 5
3 | 0 0 H 0 | 0 H 0 0 H 0 | 0 0 |
| 3 = = 4 0 | 0 H 1 - 5 = 6 = 3 |
2 - - 2 - - 3 - 4 - - - 1 | 0 | 1
0 1 - - - 3 = 3 - - 2 - - 2 0 1 0