#9X9
0 3 = 3 - - 2 0 1
1 | 1 - - 3 | 0 |
| 3 = = 2 H 3 = 4
3 - - 2 - 3 0 0 |
| 0 3 - 2 - - 1 |
2 0 H 2 - 3 - - 3
| 0 3 | 0 | 0 2 |
| 0 | 1 0 | 0 H 1
2 - 3 - - 3 - 3 0