#9X9
3 - - 3 = 3 - - 2
H 0 4 = 4 - 1 0 |
H 0 H 0 | 1 - - 4
3 - 4 - 5 - - 2 H
0 1 - 2 H 0 0 | H
3 - 2 | 3 - 1 | 3
H 0 | 4 = 3 - 2 |
H 0 1 | 0 0 0 0 |
3 - - 2 0 0 1 - 2