#9X9
2 - - 2 0 2 - 1 0
| 0 0 | 0 | 1 - 2
3 - 1 | 0 | 0 0 |
| 1 - 6 = 7 = 2 |
3 - 2 H 0 H 1 - 4
| 0 | 5 = 6 - 1 H
| 1 | | 0 | 2 = 5
1 | 1 | 0 2 - 1 |
0 2 - 3 - - 2 - 2