#9X9
2 - 5 = = 4 - 2 0
| 0 H 0 0 | 1 | 0
4 = 6 - - 2 | | 1
| 1 | 0 0 0 | 2 |
2 | 3 - 2 - 3 | 2
| 2 | 0 0 0 | 1 |
1 | | 2 - - 6 = 4
0 | 1 | 0 0 H 0 |
0 2 - 4 = = 5 - 2