#9X9
0 1 - 3 = 3 - - 2
2 - 3 = 3 - - 1 |
| 3 - 4 = 5 - - 3
2 H 0 | 0 H 0 0 |
| 4 = 5 - 4 - 1 |
| 0 0 | 1 - 2 - 3
2 - - 6 = 5 = 4 |
0 0 0 H 0 | 0 H 1
1 - - 3 0 2 - 3 0