#9X9
3 = = 3 - 2 - 1 0
| 1 - - 4 - 4 - 2
| 0 0 0 H 0 H 0 |
3 - 2 - 7 = 7 = 5
| 3 - 1 H 0 | 1 H
2 H 2 - 6 - 2 | 3
| 3 | 0 H 0 0 | |
1 | 3 = 5 - - 2 |
0 3 = 3 - 2 - - 2