#9X9
0 2 - - 2 - 3 - 2
1 | 3 - - 1 | 0 |
| 1 H 2 = = 3 0 |
2 - 5 = = 4 = = 5
0 0 0 0 0 0 0 0 H
2 - - 3 = = 5 = 6
| 0 2 - - 1 | 0 H
| 0 | 1 - - 3 - 3
2 - 3 - 2 - - 1 0