#9X9
0 2 - - 2 - - 1 0
0 | 0 4 = 3 - - 2
1 | 0 H 1 - - 2 |
| 4 = 7 = 4 0 | |
3 | 0 | 0 H 0 | 2
H | 0 3 - 5 - 3 |
H 1 0 | 1 | 0 | 1
3 - - 2 | 1 0 | 0
0 1 - - 3 - - 2 0