#9X9
0 0 1 - - 3 - 1 0
3 - - 2 0 | 3 - 2
H 0 0 | 0 | H 1 |
H 2 - 5 = 5 H | |
3 | 2 | 0 H 2 | 3
| | H 3 - 5 - 2 H
| 1 H | 0 | 0 0 H
2 - 3 | 0 2 - - 3
0 2 = 4 - - 1 0 0