#9X9
0 1 - - 3 - 3 - 2
2 - 1 0 | 1 | 0 |
| 1 - - 3 | 2 0 |
3 - - 2 | 2 | 0 2
| 0 1 | 3 | 1 0 |
| 0 | 1 H 3 = = 4
4 = 7 = 7 = = 2 |
| 0 H 0 | 0 1 - 2
2 - 3 0 2 - - 1 0