#13X13
1 0 1 0 1 0 1 0 1 - 2 - 2
| 1 | 0 | 0 | 3 - 3 = 2 |
| | 3 = 6 = 3 H 1 - 3 - 4
2 | 0 0 | 0 0 H 0 0 | 1 H
| 4 = = 5 - - 4 - 1 | | 3
2 | 0 0 | 0 1 - - - 2 | |
| 3 - 2 | 3 = = 5 - - 2 |
| | 1 | 1 | 0 0 H 0 1 - 3
2 | | 2 - 4 - - 6 - - 1 |
| 1 | 0 0 | 0 0 H 0 0 0 |
3 - 3 - 1 | 3 = 7 = 5 - 2
| 1 - 3 = 3 | 0 | 0 H 0 0
3 = 3 - 2 - 2 0 1 0 3 - 1