#13X13
2 - 3 0 1 - 2 - 2 - 4 - 3
| 0 H 2 - 5 = 4 - 3 H 0 H
3 = 6 | 0 H 0 | 0 H H 1 H
0 0 H 4 = 7 - 6 = 5 H | 3
2 - 3 | 0 H 0 H 0 | 2 | |
| 1 - 6 = 7 = 7 - 4 - 4 |
3 - 1 H 0 | 0 H 0 | 0 H 2
| 1 - 6 - 4 - 7 = 6 = 4 |
| 0 0 H 0 | 0 H 0 | 3 = 5
3 - - 7 = 7 = 6 - 4 | 0 H
| 0 0 H 0 H 0 | 0 H 2 - 5
| 1 - 4 - 5 = 5 = 4 0 0 H
3 = 3 - 3 = 3 - 2 - 2 - 3