#13X13
1 - 3 0 1 - 2 - - 3 - 1 0
0 0 H 3 = 5 - - 2 | 2 - 3
2 - 3 | 0 H 0 0 | 2 | 0 H
| 0 0 | 0 H 1 - 3 | 1 0 H
2 - - 4 = 7 - 2 | 3 - - 5
0 0 1 - 3 H 0 | 2 | 0 0 H
3 - - 2 H 4 = 3 | 5 = = 5
H 0 0 | 4 - 3 = 3 H 0 0 |
5 = = 4 | 1 - 4 - 5 - - 3
| 0 1 | 4 - 1 H 0 | 0 0 |
3 0 | 1 H 0 0 H 0 | 2 - 4
H 0 2 - 4 - - 5 = 3 | 0 H
3 - - 3 = 3 - - 2 - 4 = 4