#13X13
0 1 - - 2 - 2 - 2 - 2 0 1
2 - - 3 - 5 = 5 = 2 | 1 |
| 0 1 | 0 H 0 | 0 0 | | 2
| 0 | 1 0 H 0 3 - - 2 | |
2 - 5 = = 5 0 | 0 0 0 | 2
0 1 | 1 0 | 0 3 - 3 - 3 |
1 | 1 | 0 | 0 | 0 | 2 | 2
| 3 - 3 - 3 0 | 0 1 H 2 |
2 | 0 0 0 | 0 4 - - 4 | 2
| | 2 - - 4 0 H 0 1 | 1 |
2 | | 0 0 H 0 H 0 | 1 0 |
| 1 | 2 = 5 - 4 - 4 = = 3
2 - 3 - 3 = 3 - 2 - - 1 0