#13X13
2 - 2 - 2 0 2 - - 2 0 0 1
| 3 = 3 | 1 | 1 0 | 0 2 |
2 | 0 | | | 2 | 0 | 0 H 2
| 3 0 | 1 | | 2 - 5 - 4 |
2 H 0 | 0 | 3 - 1 H 0 | 2
| 4 = 7 = 4 | 1 - 7 = 4 |
| 0 0 H 0 | 3 - 1 H 0 | 2
2 - - 6 - 4 | 1 - 6 = 4 |
0 0 0 H 0 H 1 0 0 | 1 | 2
0 3 - 6 = 7 - - 1 | | 3 |
1 H 0 | 0 H 0 0 0 | 2 H 2
| 2 0 | 0 3 - 2 - 2 | 2 |
2 - - 3 - - 2 - 2 - 3 - 2