#13X13
0 1 - 2 - 2 - 2 - 3 - 1 0
1 - 4 - 5 = 5 = 2 | 1 - 2
0 0 H 0 H 0 | 1 - 5 - 1 |
2 - 6 = 5 - 3 - 1 H 0 0 |
| 0 | 3 - 3 - 3 = 7 - - 3
| 0 2 H 0 | 0 0 0 H 1 0 |
2 0 | 5 = 4 - - - 3 | 0 |
| 0 1 | 2 = = 3 - - 4 - 4
4 - - 5 = 4 - - - 1 | 0 H
H 0 0 | 0 | 2 = 5 - 5 = 6
H 2 - 2 0 | 0 0 H 0 | 0 H
2 | 1 - - 3 - - 5 = 4 - 3
0 2 - - 3 = = 3 - 2 - 1 0