#13X13
2 - 2 - 2 - - 2 - 2 - 2 0
| 3 - 4 - 3 - - 1 0 0 | 1
2 H 0 H 0 | 0 0 0 0 0 1 |
| 5 = 8 = 5 - 4 - 4 = = 4
2 | 0 H 0 | 0 H 0 | 0 0 |
| 3 - 7 = 7 = 8 = 5 - 3 |
2 | 0 H 0 H 0 H 0 | 0 H 2
| 3 = 6 - 7 = 6 - 4 = 4 |
| 0 0 | 0 H 0 | 1 - 2 - 3
3 - - 5 = 7 = 7 = 4 - 2 |
| 0 0 | 0 | 0 H 0 | 1 | 1
2 - 1 | 0 | 0 3 - 2 | 1 0
0 1 - 2 0 2 - - 2 - 3 - 1