#13X13
0 1 0 3 = 3 - 3 = = 3 - 2
1 | 1 | 2 - 5 = 4 - - 3 |
| 3 | 1 | 0 H 0 | 0 1 H 3
3 H 3 = 7 = 7 = 5 0 | 3 H
H H 0 0 H 0 | 0 H 0 | | 3
H 4 - - 6 = 6 - 5 - 2 | |
H | 0 0 | 0 H 0 | 0 0 | 2
3 | 3 - 4 - 7 = 5 - - 2 |
| | H 0 | 0 H 0 | 0 0 0 |
| 2 H 0 5 = 7 = 6 - 3 - 3
| | 3 0 H 0 | 0 H 0 | 1 |
| 1 | 0 3 - 3 - 5 = 3 | 1
2 - 3 - - 2 - 3 = 3 - 2 0