#13X13
0 1 - - 3 - - 3 - - 4 - 2
2 - - 1 | 0 0 | 0 2 H 1 |
| 1 - - 3 - 1 | 0 H 2 | 2
2 - 5 = = 5 - 4 - 7 = 4 |
0 0 H 1 0 H 0 | 0 H 0 | 3
0 0 H | 0 H 0 | 0 4 - 4 H
2 - 5 | 0 5 = 3 0 | 0 H 3
| 0 H 2 0 | 0 0 0 | 0 H |
3 = 4 | 0 | 1 - - 4 = 5 |
0 2 - 5 = 4 - - 5 = 2 | 3
1 | 2 | 0 0 0 1 H 2 = 4 H
| 1 H 1 0 0 0 | 3 - 1 | 2
2 - 4 - - 2 - 3 - 2 - 2 0