#13X13
2 - - 2 0 0 1 - 3 = 3 - 2
| 0 1 | 1 - - 5 = 4 - 1 |
| 0 | 2 - - 1 H 0 | 0 0 |
2 - 4 = = 3 - 5 - 4 - - 4
0 1 - 4 = = 2 | 0 | 0 0 H
2 - 1 | 0 3 - 2 0 | 0 0 H
| 0 0 | 0 H 3 = = 6 = = 5
2 - - 5 - 4 | 1 0 | 0 0 |
0 0 0 H 0 | 1 | 0 2 - 1 |
3 - - 7 = 5 - 3 - - 4 = 4
H 0 0 H 0 | 1 - - 2 | 0 |
H 1 - 4 - 3 - - 1 | 1 0 |
3 - 3 = 3 - 2 - - 3 - - 2