#9X9
0 0 3 - 3 = = 2 0
1 0 H 0 0 0 0 0 0
| 0 H 3 - 4 - - 1
4 - 3 H 0 H 2 0 0
H 0 0 H 0 2 H 0 0
5 = = 8 = = 6 = 3
| 0 0 H 0 1 0 0 |
1 0 0 H 0 | 0 0 1
0 1 - 4 - 3 - 1 0