#9X9
0 0 0 0 0 0 0 0 0
0 0 3 = = 3 0 0 0
0 0 | 0 0 | 0 0 0
0 0 | 0 0 2 0 0 0
1 - 4 - 1 | 2 = 4
0 0 | 0 0 2 0 0 H
0 0 | 0 0 | 0 0 H
0 0 2 - - 3 - - 3
0 0 0 0 0 0 0 0 0