#17X17
2 - - 2 0 1 0 1 - 2 - - 2 - 2 - 2
| 0 1 | 0 | 2 - 4 - 3 - - 4 = 3 |
2 0 | | 0 | | 1 H 0 | 1 0 | 0 | 3
| 0 | 4 = 4 | | 4 = 3 | 0 | 0 2 H
2 - 4 | 0 | | 3 = 5 = 6 - 2 0 | 3
0 0 H 1 0 | 2 - 1 | 0 H 1 - - 3 |
2 - 6 - - 3 - 5 = 5 - 6 - - 2 | |
| 0 H 0 3 - 1 H 0 | 0 H 1 0 | | 2
| 0 H 0 H 1 - 5 - 4 = 5 | 0 | 1 |
3 = 7 - 7 = 3 | 0 0 0 | 4 - 2 0 |
0 0 H 0 H 0 | 2 - - - 2 H 2 - - 3
2 - 5 = 7 - 4 - - 2 - - 3 | 0 1 |
| 2 - 3 H 0 | 0 0 0 0 0 0 | 0 | 2
2 | 0 H H 0 5 = 4 - - 4 = 7 = 4 |
| | 0 H 2 0 H 0 | 0 0 | 0 H 0 | 1
| 3 = 5 - - 4 - 3 - 1 | 0 H 0 | 0
2 - 2 - 2 - - 2 - 2 - 2 0 3 - 2 0