#17X17
2 - 4 - 2 - - 2 - 3 0 1 - - 2 0 2
| 0 H 1 - 3 = = 3 H 1 - 3 0 | 0 H
3 = 7 - 3 - - 3 | 3 - 2 H 0 | 0 H
0 0 H 0 | 0 1 H 4 = 4 | 5 - 4 = 5
2 - 5 0 | 0 | 2 | 0 H 1 H 0 0 0 |
| 0 H 0 4 - 4 - 5 - 6 = 8 = = 3 |
| 0 H 0 H 0 | 0 H 0 | 0 H 0 0 | |
3 = 8 = 7 = 5 = 6 = 5 - 6 - 2 | 2
0 1 H 0 | 0 0 0 0 0 | 0 H 0 | 2 |
1 | 3 - 6 = = 4 - - 5 = 6 0 | | 2
| | 0 0 H 0 0 | 0 0 | 0 H 0 2 | |
| 4 - - 5 - 1 | 3 - 3 - 3 0 | 1 |
| H 0 0 | 1 - 2 H 1 - 2 - - 5 - 3
2 H 3 = 7 = 5 = 6 - 2 - - 3 H 0 |
| 2 | 0 H 1 | 1 | 0 0 0 0 H 5 = 4
| 0 | 0 2 | 1 | 2 - - 3 = 4 | 0 |
2 - 2 0 0 2 - 3 - - 2 - 2 - 2 0 1