#17X17
0 1 0 1 0 1 0 0 1 - 2 - - 3 - 2 0
0 | 0 | 0 | 1 - - 4 - - 1 | 1 | 0
2 | 0 5 = 5 - 1 0 H 0 0 0 | | | 1
H 2 0 H 0 | 1 - - 6 = 4 - 3 | 1 |
3 | 0 H 0 | 0 0 0 | 2 | 0 | 3 - 3
| 4 = 7 - 4 = 5 - 3 H | 0 2 | 1 |
3 | 0 H 3 - 1 H 0 | H 1 0 | 2 | 3
H 4 - 3 H 0 0 H 0 | 3 - - 2 | 3 H
3 H 2 - 5 = = 8 = 6 = = 4 - 2 H 4
| 3 | 2 - 3 0 H 0 | 0 0 | 2 - 5 H
2 | 2 | 0 H 0 H 0 | 1 - 2 | 0 H 3
| 1 | 4 = 8 = 7 - 3 - 4 = 6 = 5 |
3 - 3 | 0 H 0 H 0 0 0 | 0 | 1 | 3
| 1 | 3 - 4 - 6 - - 1 | 0 3 | 3 H
1 | | | 0 0 0 H 0 1 - 3 0 H 2 H 3
0 | 1 | 1 - - 4 - - 1 | 0 2 | 2 |
0 2 - 2 0 0 1 - 2 - - 2 0 0 2 - 2