#17X17
3 - 2 0 3 = = 3 - - 2 - - - - 1 0
H 1 | 0 | 0 1 - - 2 - - 4 - 4 - 3
3 | 3 = 6 = = = 3 - 2 0 H 0 H 0 H
| 4 = 3 | 0 2 - - 1 | 0 H 0 4 = 5
| | 0 | 2 0 | 1 - - 5 - 5 - - 1 |
3 | 0 1 | 0 | 0 0 0 H 0 | 0 0 0 |
H 4 - - 6 = 5 = 3 - 6 = 5 - 4 - 3
H H 0 0 H 0 0 0 0 0 | 0 | 0 H 2 |
3 H 1 - 6 = = 3 - 1 | 0 4 = 4 H 2
| H 0 0 | 1 - - 2 - 2 0 | 0 0 H |
| 4 - - 4 - 5 = = 4 - - 5 = = 5 |
2 | 1 0 | 0 H 0 0 | 1 0 | 1 0 | 2
| 1 | 0 5 = 7 = = 5 | 0 1 | 0 | |
4 = 5 0 H 0 | 0 0 H 3 = = 7 = 4 |
| 0 H 0 H 0 2 - - 4 - - 2 H 0 | 2
2 - 4 - 4 - - - 2 - 1 0 | 3 - 2 |
0 1 - 3 = = = 3 - 2 - - 2 0 1 - 2