#17X17
2 - 2 - 2 - 2 - 2 - - 2 - 2 - - 2
| 4 = 5 = 3 - 3 = 3 - - 3 = = 3 |
2 H 0 | 0 0 0 0 0 0 0 0 0 0 0 | 2
| 3 0 | 2 = 4 = 3 - - 3 - 5 = 5 |
2 | 0 3 = 3 - 3 = = 2 | 0 H 0 H 2
| 3 = = 3 - 2 - - 2 - 5 = 7 - 5 |
2 - - 5 = 3 - - 2 - 1 | 0 H 0 H |
0 0 0 H 1 - - 2 - 4 = 6 - 5 0 H 2
2 - - 5 - - 3 = 4 | 0 H 0 H 0 3 |
| 0 1 | 0 0 0 0 H | 0 H 0 H 0 | 2
2 0 | | 2 - - 1 H 2 - 6 = 7 = 5 |
| 0 | 1 | 0 0 0 H 0 0 | 1 | 0 H 2
2 - 4 = 6 - 3 - 4 - - 3 | 2 - 3 |
0 2 - 1 H 0 | 3 = 4 0 | 4 = 6 = 4
1 | 0 0 H 0 1 | 0 H 0 | | 0 H 0 |
| 2 - - 4 - - 3 - 5 = 3 | 0 H 0 |
3 = = 3 - 2 - - 3 = 3 - 2 0 3 - 2