#17X17
3 - 2 - - 2 - 2 - 2 - 2 0 1 0 0 1
H 2 - 5 = = 4 - 3 - 1 | 0 | 0 1 |
3 | 0 H 0 0 | 0 | 0 0 | 0 | 0 | 2
| | 0 3 - 1 | 0 5 = = 6 = 7 = 3 |
| 4 = = 4 - 3 0 H 0 0 | 0 H 2 - 4
2 | 0 0 | 1 | 0 4 - - 3 - 4 | 0 H
| 3 - 1 | | 3 0 | 0 4 = 4 | 4 = 5
| | 4 = 4 | H 0 | 0 H 0 H | | 1 |
2 | H 1 | | 5 - 5 = 5 0 H 1 | | 2
| 2 H | | 2 H 0 | 0 | 0 4 - 2 | |
3 | 3 | 1 | 2 0 | 0 2 0 | 1 - 3 |
H 2 | 5 = 6 - - 3 0 | 0 | 0 0 | 3
3 | 2 H 0 H 0 2 | 0 2 - 4 = = 4 H
| 2 | 3 0 H 0 H 5 = = 3 - 3 0 | H
3 | 1 | 0 5 = 6 H 0 0 0 0 H 0 | 3
H 1 0 | 0 | 0 H 3 - 2 - - 4 - 2 |
3 - - 2 0 2 - 3 0 1 - 3 = = 3 - 2