#17X17
1 0 1 0 3 = 3 - - 3 = 3 - 2 - 1 0
| 0 | 0 | 3 - 4 - - 3 - 3 - 4 = 4
| 0 3 = 5 H 1 H 0 0 | 0 | 0 | 0 H
2 - - 2 H 2 | 5 = = 4 0 | 0 4 - 5
0 1 0 | 3 - 3 | 0 0 | 0 3 0 H 1 H
1 | 0 4 - 2 | 2 - 3 | 0 H 0 H | 3
| 2 0 H 0 | 3 - 1 H 5 = 7 = 4 | |
2 | 0 H 0 1 | 1 - 3 H 0 | 0 0 | 2
| 5 = 6 = = 4 - 3 = 7 - 5 = = 4 |
2 H 0 0 0 0 0 0 0 0 H 1 | 0 0 | 2
| H 2 - - 2 - 3 - 1 H | 3 - 1 | |
2 H | 2 - - 2 | 0 0 H 2 | 0 0 | 3
| 2 | | 1 0 | 2 - - 3 | 3 - - 2 H
2 - 4 | | 0 4 = = 5 - 3 | 2 = = 5
0 0 H 1 | 0 | 0 0 H 0 | 2 - 3 0 |
1 - 4 - 3 - 3 - - 5 = 3 0 0 H 0 |
0 1 - 3 = 3 - 3 = = 3 - 2 - 4 - 2