#17X17
2 - - 3 0 2 - 2 - 3 = 3 - 2 - 1 0
| 0 0 H 0 | 2 - 2 - 4 = 3 - 5 = 3
4 = = 7 = 5 | 2 - 2 | 0 0 0 H 0 |
| 0 0 | 0 H 1 | 0 | | 3 - - 5 - 4
| 1 0 | 0 H 0 | 0 1 | H 0 0 | 0 H
2 | 0 4 - 6 = 5 - - 2 H 2 = 5 = 5
| 2 0 H 0 | 1 | 0 4 = 6 - 4 - 2 |
2 | 0 H 0 | | | 0 H 0 | 0 H 0 | 2
| 4 = 8 = 4 | 3 - 4 - 5 = 8 = 4 |
3 | 0 H 0 | 2 | 0 0 0 | 0 H 0 | 2
H 4 - 5 - 4 | 2 - - 1 | 0 H 0 2 |
H H 0 | 0 H 3 - - 3 - 5 - 3 0 | 2
H H 0 | 0 H | 1 0 | 0 H 4 = = 4 |
H 5 = 5 = 4 | | 0 | 1 H H 0 1 | 2
2 | 0 0 0 0 | 2 - 2 | 2 H 0 | 1 |
0 | 1 - 2 - 3 - 3 = 4 - 4 - 3 - 2
0 2 - 2 - 3 = 3 - 3 = 3 - 2 - 1 0