#17X17
0 1 - 2 0 1 - 2 - 2 - - 2 - - 2 0
2 - 3 | 1 - 4 = 6 = 4 - - 1 0 | 1
| 0 H 2 - 2 | 0 H 0 | 0 0 0 0 | |
2 0 H 0 0 | 2 - 6 - 6 = 5 - - 3 |
| 0 5 = = 6 - 1 H 0 H 0 H 0 0 | 3
| 0 | 0 0 H 1 - 7 = 6 - 6 - 3 | H
2 0 3 - - 4 - 1 H 0 | 1 H 0 H | 3
| 1 | 2 = = 4 - 6 - 3 | 2 0 H 2 |
2 | 4 - - 2 | 0 H 0 | 3 - - 5 | 2
| | H 0 1 | 5 = 8 = 3 | 0 0 H 1 |
| 2 H 0 | 1 H 0 H 1 - 5 = = 7 - 3
| | 3 - 6 = 6 - 7 = 2 | 0 0 H 0 |
3 | 0 0 H 0 | 0 H 1 - 4 - - 7 = 4
H 3 - - 4 - 5 = 7 - 2 | 0 0 H 0 |
2 | 0 0 0 0 | 0 H 0 | 3 = 2 H 0 |
0 | 0 1 - - 3 - 5 = 4 - 2 - 4 - 2
0 3 = = 3 - - 3 = 3 - 2 - 2 - 1 0