#17X17
0 1 - 2 - - 2 - - - 2 - 2 - 2 0 2
2 0 3 = = 5 - - 2 - - 2 - 1 | 0 H
H 0 | 0 0 H 0 2 - 2 - - 4 = 5 = 5
H 0 | 0 0 H 0 | 2 = = 3 | 0 0 0 |
4 = 5 - - 6 - 3 - - 2 | | 2 - - 3
0 1 | 0 0 H 0 0 0 0 | 3 | | 0 1 |
1 | 2 - 1 H 1 - 3 = 3 H 1 | 0 | 3
| 2 - 5 = 7 = 5 - 4 - 6 = 6 - 3 H
3 - 1 H 0 | 0 H 0 H 0 | 0 H 0 | 3
| 3 = 6 - 4 - 5 = 8 = 6 = 7 = 4 |
2 | 0 | 0 | 2 - 1 H 0 | 0 | 1 | 2
| 1 0 | 0 1 | 0 0 H 0 | 0 2 | 1 |
2 - - 3 - - 4 = = 6 - 4 0 | 4 - 3
0 0 0 0 0 0 0 0 0 | 0 H 0 | H 0 |
3 = 6 = 3 - - 2 - 2 0 H 0 1 H 0 |
| 0 H 1 - - 2 - 2 - - 5 = = 6 = 3
2 - 4 - 3 = = 3 - - 2 - 2 - - 1 0