#9X9
2 - 3 0 0 3 - - 2
| 0 H 0 0 H 0 0 |
4 = 5 - 1 H 4 = 5
| 1 - 2 - 3 H 0 H
2 - 4 - 2 - 4 - 5
0 0 H 3 = 5 - 2 H
2 - 3 | 0 H 2 | 3
| 0 0 | 0 2 H 1 |
2 - - 2 0 0 3 - 2