#9X9
2 - - 2 0 2 - 2 0
| 0 0 | 2 | 0 | 2
| 2 = 5 H | 0 2 H
3 - 2 H H 1 0 | 4
| 1 | H 3 - - 3 H
2 | | 4 - - 1 | 3
| 2 | | 0 2 - 2 |
1 | 1 | 0 | 0 0 |
0 2 - 3 - 3 - - 2