#9X9
2 - - 2 - 2 0 0 2
| 0 3 - 1 | 0 1 H
2 0 H 0 0 | 0 | 3
| 0 3 - - 3 - 2 |
2 - - - 2 - - - 4
0 2 - 3 - - 3 0 H
1 | 0 | 0 0 H 0 3
| 1 0 | 1 - 3 0 |
2 - - 3 - 2 - - 2