#9X9
1 0 2 - 2 - - 1 0
| 0 | 2 - - 2 - 2
4 = 4 | 2 - - 2 |
| 1 | 1 | 0 0 | 2
2 | 2 - 5 - 2 | |
| | 0 0 H 1 | 1 |
| 2 - - 3 | 4 = 4
2 - - 2 - 2 | 0 |
0 0 1 - 2 - 2 0 1