#9X9
2 - 3 - 3 - - 2 0
| 2 | 2 | 1 0 | 2
| H 1 H 2 | 0 2 H
2 H 0 H | | 0 | 3
| 5 - 4 | 3 = 3 |
| H 0 | 2 - - - 3
| 5 = 7 = = 3 0 |
1 | 0 H 0 0 | 0 |
0 2 - 3 0 0 2 - 2