#9X9
0 3 - - 3 - - 2 0
1 H 0 0 | 0 0 | 1
| H 2 0 | 1 - 2 |
2 H H 0 3 - 2 - 3
| 2 H 0 | 1 - 3 |
3 - 4 - 4 - 3 H 2
| 2 - 1 | 0 H 3 |
1 | 0 0 | 0 2 | 1
0 2 - - 3 - - 2 0