#9X9
2 - 2 - 3 - 1 0 0
| 1 - 3 | 1 - - 2
| 0 0 H 4 = = 2 |
2 - - 4 | 0 1 - 3
0 0 0 | 4 - - 1 |
3 = 3 | H 2 - - 3
| 0 | | 3 | 1 0 |
1 0 | 1 | 1 | 0 |
0 0 2 - 3 - 3 - 2