#9X9
1 0 2 - - 2 - 2 0
| 0 | 0 2 - 3 | 2
2 0 | 0 | 0 H 2 H
| 0 5 = 7 = 5 | H
| 0 H 0 H 0 | | 3
2 - 7 = 7 - 3 | |
0 0 H 0 H 0 | | 2
2 = 5 - 3 0 | 1 |
0 1 - 2 - - 3 - 2