#9X9
0 1 - 2 - 3 - 3 0
2 - 4 - 1 | 0 H 1
| 0 H 0 0 | 0 2 |
4 = 6 = = 5 - - 3
| 2 = = 3 | 1 0 |
3 - - 2 | 1 | 0 3
| 0 0 | | 0 | 0 H
2 - 1 | 3 = 4 - 3
0 1 - 3 - 2 - 1 0