#9X9
0 1 - 3 - - 2 0 1
2 - 3 | 0 0 | 0 |
| 0 H 3 - 1 | 0 |
3 = 6 | 1 - 6 = 4
0 0 H 2 - 1 H 0 |
3 = 7 - 3 - 5 - 4
| 0 H 0 | 1 | 0 H
| 0 H 0 1 | 3 = 4
2 - 4 - - 3 - 1 0