#13X13
0 2 - 3 - - 2 - 3 - - 1 0
1 | 2 | 2 - - 1 | 0 0 0 0
| 2 H 3 | 2 - - 4 - 3 - 2
2 | 4 H | | 0 0 | 0 | 0 |
| 1 H H 2 | 4 = 4 0 | 1 |
| 0 H 2 | 1 H 0 | 0 2 | |
2 - 6 - 5 = 8 = 4 0 | | 2
0 0 H 0 | 0 H 0 | 0 1 | |
2 - 6 = 6 - 6 - 5 = = 3 |
| 1 | 0 H 0 H 0 | 1 - - 3
1 | 2 - 4 0 H 2 | 0 0 0 |
0 | 0 0 | 0 2 H 2 - 2 - 2
0 2 - - 3 - - 4 - 3 = 2 0