#13X13
0 1 - - 2 - 2 - - 2 - - 2
2 - 4 = = 4 - 3 - - 1 0 |
| 0 | 0 0 | 0 | 0 2 - - 3
2 0 | 2 = 5 0 | 0 | 0 0 |
| 0 1 0 0 H 0 3 - 3 - 1 |
3 - - - 1 H 0 | 3 - 3 - 4
| 0 1 - - 6 = 5 H 0 | 0 H
3 - - - 1 | 0 H 4 = 6 = 6
| 3 - 5 = 5 - 6 - 1 | 0 H
| H 0 H 0 | 0 H 1 - 5 - 4
1 H 0 H 0 | 0 H 0 0 H 0 |
0 H 0 3 - 4 = 5 - - 5 = 3
0 3 - - - - 2 - 2 - - 1 0