#13X13
0 1 - 2 0 3 = = 3 - 2 - 2
3 = 2 | 0 | 2 - - 2 - 1 |
| 0 0 | 0 1 | 0 1 - 3 = 4
2 - - 4 - - 4 - - 5 = 3 |
0 1 0 | 0 0 | 2 0 H 0 | 2
1 | 0 | 1 - 3 H 0 H 0 | |
| 2 - 3 - 1 | 4 = 6 - 3 |
| 0 1 - 4 - 5 - 1 | 0 | 2
3 - - 1 H 0 H 0 0 | 0 1 |
| 2 - - 6 = 6 - - 4 - - 3
2 | 0 0 | 0 | 0 0 | 0 0 |
| 2 - 1 | 0 2 - 1 | 1 - 2
2 - 2 - 2 0 0 1 - 3 - 1 0