#13X13
2 - - 2 - - - 2 - 2 - 1 0
| 0 0 0 0 3 - - 3 - 4 - 2
3 - 3 0 0 H 0 0 | 0 H 1 |
| 1 H 2 - 7 = = 5 = 5 | 2
2 | 2 | 0 H 0 0 0 0 | | |
| 3 - 5 = 8 = 5 - 2 | 2 |
2 | 1 | 0 H 0 H 0 | 1 | 2
| 2 | 2 - 4 - 7 = 6 = 4 |
| | | 0 0 0 0 H 0 | 1 | 2
2 | 4 = 5 - - 5 - 2 | 1 |
| 1 | 0 H 0 0 | 0 0 3 = 4
2 - 3 - 5 = = 3 0 0 0 0 |
0 1 - 2 - 2 - - - 2 - - 2