#13X13
1 0 1 0 0 1 - - 2 - 2 - 2
| 1 | 0 1 - - 3 - 4 - 3 |
| | | 0 0 0 0 | 0 H 0 H 2
2 | 2 - - 5 = 6 = 6 = 5 |
| 3 - - 1 H 0 | 0 0 0 | 2
2 | 0 1 - 4 - 4 - - 1 | |
| 3 - - 3 = 2 | 1 - - 2 |
2 | 1 - - 3 - 4 = 3 - - 3
| 3 - - 1 | 0 0 0 0 0 0 |
| | 0 4 = 6 = = 6 = 4 - 3
3 | 0 H 0 | 0 0 H 0 | 0 |
H 2 - 4 - 3 - - 3 0 | 0 1
3 - 2 - 2 - - 2 - - 2 0 0