#13X13
2 - 2 0 2 - - - 2 - - 2 0
| 1 | 0 | 0 4 = = 4 0 | 1
2 | 1 0 | 0 H 0 0 H 0 | |
| 3 - - 4 - 5 - - 6 - 3 |
2 | 0 1 | 1 | 0 0 H 0 | 2
| 2 0 | | | 4 = = 7 = 4 |
2 | 0 | 1 | | 0 2 | 0 | 2
| 2 - 5 - 3 | 0 H | 0 2 |
| 0 0 H 0 | 1 0 H 1 0 | 2
3 - - 5 = 4 - - 6 = = 4 |
| 2 - - 2 - 1 0 | 0 1 | 2
1 | 0 0 0 0 0 0 | 0 | 1 |
0 2 - 2 - - 2 - 3 - 3 - 2