#13X13
2 - 2 0 0 1 0 1 0 1 0 1 0
| 1 | 0 0 | 0 | 0 | 0 | 1
2 | 4 = = 5 = 7 = 6 = 5 |
| 3 | 0 0 0 0 H 0 | 0 H 2
2 H | 0 1 - - 4 - 4 - 4 |
| H 3 - - - 2 - 1 | 0 | 2
| 3 | 4 = 5 = 3 - 2 0 | |
2 | 1 H 0 | 1 - - - - 3 |
| 2 - 4 - 4 - - 2 - 1 | 3
| 0 0 0 0 | 1 - - 2 - 3 H
2 - 2 - - 3 - 4 - - 2 | 3
0 0 0 0 0 0 0 H 0 0 | 1 |
1 - - 2 - 2 - 5 = = 4 - 2