#13X13
0 1 0 1 0 2 - 3 - - 2 - 2
1 | 0 | 1 | 1 | 0 2 - 1 |
| 4 = 5 | 1 | 1 0 | 0 0 |
| | 0 H 2 - 3 - - 5 = = 5
| 4 - 5 - - - - 1 | 0 0 H
2 H 0 | 0 3 = 5 - 4 - - 5
| H 0 | 0 | 0 H 0 | 0 0 H
| 4 = 5 - 3 - 3 0 | 0 0 H
| 0 0 | 1 - - - - 6 = = 5
2 - - 5 - - 2 - 1 H 0 0 |
0 0 0 H 2 = = 3 - 6 = = 3
0 1 - 4 - - 2 - 1 | 0 0 0
1 - 2 - - 2 - 2 - 3 - 1 0