#13X13
0 1 - 2 - 2 - - 2 0 2 = 3
2 - 2 - 5 = = 3 | 0 0 0 |
| 0 0 0 H 0 0 | 3 - - 2 |
| 1 - - 5 - - 2 | 0 0 | 2
2 - 3 0 | 2 - - 4 - 3 | |
0 0 H 0 | | 0 0 | 0 H 1 |
2 - 7 = 5 | 2 = 6 = 8 = 4
| 0 H 0 H 1 0 0 | 0 H 0 |
| 0 3 - 5 - - 1 | 0 3 - 3
3 - - 1 | 3 - - 4 - - 2 |
| 1 - - 3 H 0 2 | 0 0 | |
3 = = 2 | 2 0 H 2 - 1 | 1
0 0 1 - 3 - - 4 - 2 - 2 0