#13X13
0 1 - 3 = 3 - - 2 0 1 0 1
2 - 4 - 3 - - 3 | 0 | 1 |
| 0 H 0 | 0 0 H 4 = 4 | 2
3 = 8 = 6 = 3 H | 0 | 2 |
0 0 H 0 | 1 | 3 | 0 1 | 2
2 - 5 = 4 | 2 | 3 - - 2 |
| 0 0 0 | 2 | 2 | 0 0 0 |
| 3 = = 4 | 2 | 4 = 6 = 4
2 | 1 0 | 2 | 1 | 0 H 0 |
| 2 | 0 | | 3 = 7 = 7 = 5
2 | 4 = 4 | 0 0 H 0 | 0 H
| 1 | 0 | 3 = = 5 - 3 - 3
2 - 2 0 3 = = 3 - 2 - 1 0