#17X17
2 - - 2 - 2 - 4 = 4 0 0 1 - 2 - 2
| 0 4 = 5 - 2 | 0 H 0 0 0 0 0 0 |
2 0 H 0 H 1 | 2 - 4 - 3 - 3 - - 4
| 0 H 1 H | 3 = 2 0 0 | 0 | 0 0 H
| 0 H | H 3 - 2 - - 1 | 0 4 - 1 H
2 - 5 | 3 | 1 - - - - 3 0 H 2 = 5
0 0 H | | 3 - - 3 - 1 | 0 H 0 0 |
1 0 H 2 | | 0 1 | 2 - 5 = 6 - - 4
| 0 2 | 1 | 0 | 3 | 0 | 1 | 0 0 H
2 - - 3 - 4 - 2 H 1 0 | | 4 = = 5
0 0 0 0 0 | 1 - 4 - - 3 | | 0 0 |
0 0 2 = = 4 - 3 - - 1 | 3 | 2 - 3
1 - - 4 - - 1 | 0 3 = 5 H | | 0 |
0 0 0 H 0 0 0 | 0 | 0 H H 1 | 0 |
3 - - 4 - 2 - 3 - 3 - 3 H 0 | 0 2
H 1 - - - - 2 - 3 = 3 - 4 - 2 0 |
3 - 2 - 2 - - 2 - 2 - 2 - - - - 2