#17X17
0 1 0 3 = 3 - 3 = = = 3 - 2 - 1 0
1 | 0 | 1 - 3 - - 5 = = 5 = 5 - 2
| | 0 | 0 0 | 0 0 H 0 0 | 0 H 0 |
| 4 = 7 = = 6 = = 7 = 2 | 0 2 0 |
| | 0 H 0 0 | 0 1 | 1 - 3 - - - 3
| 3 - 5 - - 4 0 | 4 - 3 - - 2 0 |
2 | 0 | 0 0 H 0 | H 1 | 0 0 | 1 |
| 1 0 | 4 = 6 - 3 H | | 1 - 3 | |
2 - - 2 H 0 | 2 | 3 | 3 - 2 | | 2
0 2 = = 6 - 4 H 2 | 2 | 0 | | 3 |
2 - 3 0 | 0 H H | 1 | 1 0 | 1 H 2
| 0 H 0 | 0 H 3 | 0 3 - - 5 = 4 |
3 = 7 - 4 = 4 | 1 0 | 0 1 | 0 0 |
0 0 H 1 - 2 - 5 - - 3 0 | 3 - - 3
0 0 H 0 0 0 0 H 0 0 | 0 | | 0 0 |
1 - 4 - 2 - - 5 = = 4 - 2 | 1 - 2
0 1 - - - 3 = = = 3 - 2 - 3 - 1 0