#17X17
0 1 - - 3 = 3 - - 2 0 2 - - 2 0 2
2 - 3 - - 2 - 3 0 | 0 | 1 0 | 0 H
| 1 | 0 2 - 1 H 0 | 0 1 | 2 | 0 H
2 | 1 0 | 2 = 6 - 5 = = 3 H 3 = 5
| 5 = = 6 = 2 | 1 | 0 1 - 4 - 2 |
2 H 0 0 | 0 0 | | 4 - - 2 - 1 | 3
| 4 - - 5 - - 2 | H 2 - - 2 - 3 H
2 | 0 0 H 0 0 0 | 4 | 0 0 0 0 | 3
| 5 = = 6 - 2 - 2 H 2 - 4 = = 5 |
2 H 0 0 | 0 0 0 0 H 0 0 | 0 0 H 2
| 5 = = 6 = = 6 = 6 - - 5 - - 4 |
2 | 0 0 | 0 0 H 0 | 0 0 H 0 0 | 2
| 2 - 1 | 0 0 H 0 4 = = 8 = = 4 |
3 - 2 - 5 = = 6 0 | 0 0 H 0 0 | 2
| 0 0 0 | 0 0 H 0 | 1 - 4 - - 2 |
| 1 - - 3 - - 4 - 3 - 2 - - 2 - 2
2 - 2 - - 2 - - 3 = 3 - - 2 - 1 0