#17X17
0 2 - 3 - - 3 - - 2 0 1 0 0 2 - 3
1 | 1 | 1 0 | 0 0 | 0 | 0 0 | 0 H
| 2 | 1 | 0 | 3 = 7 = 5 - 1 | 0 H
2 | | 0 2 - 3 | 0 H 0 | 2 - 5 = 5
| | 3 - - 1 | 2 - 7 = 4 | 0 | 1 |
| 1 | 1 - - 5 = 2 H 0 | 3 0 | | 3
| 0 2 - - 2 | 1 - 4 - 4 H 0 2 | H
3 - - 1 0 | 5 = 3 - 3 H 2 0 | 2 H
| 0 2 - - 4 H 2 - 1 H 5 - - 3 | 3
2 0 | 0 1 H 2 | 1 - 5 H 0 1 | 2 |
| 0 | 0 | 6 = 5 - 1 H 2 0 | 2 | 2
2 - 5 - 2 H 0 | 1 - 6 - - 4 | 2 |
0 0 H 1 - 6 - 4 - 3 H 0 0 H 2 | |
2 - 4 - 1 H 0 | 0 H 4 - 1 H | | 2
| 0 0 1 - 6 = 6 = 4 | 0 0 2 | 2 |
| 0 0 0 0 | 0 | 0 0 | 1 - - 2 | 1
2 - 2 - - 2 0 2 - - 3 - - 2 - 2 0