#17X17
2 - 3 0 2 - - 4 - 3 = 3 - - 2 - 2
| 0 H 0 | 0 0 H 1 - 2 - - 3 - 2 |
| 0 H 0 3 = = 5 - 2 - 1 0 | 0 | 2
3 = 7 - - - 3 - 3 - 2 - 2 | 0 2 |
0 0 H 3 = 4 | 1 | 3 - 1 | 1 0 | 2
0 0 4 | 0 H 1 | 2 H 2 - 4 - - 2 |
1 0 H 2 - 4 - 3 | H | 0 | 0 2 - 4
| 0 H 0 0 0 0 | | 3 | 1 | 0 | 0 H
2 - 6 - 2 - 1 | 1 | 1 | 4 = 7 = 5
0 0 H 1 - - - 4 = 6 = 4 | 0 H 0 |
3 - 5 = = 3 - - 1 | 1 | 2 - 6 - 3
H 2 - - 4 - 2 - - 3 | 2 - 1 H 0 |
3 | 0 0 H 0 0 0 0 | | 0 0 0 H 0 |
| 4 = = 5 - - - 1 | 2 - - - 6 = 4
2 | 1 - - - 2 - - 4 - - 1 0 | 0 |
| 2 - 2 - - - - 1 | 0 0 0 0 | 0 |
2 - 2 - - 2 - 2 - 2 0 0 1 - 2 0 1