#17X17
2 - 2 - - 2 0 1 - 2 - 2 - - 2 - 2
| 2 = 3 0 | 1 - 5 = 5 = = 5 - 2 |
2 - 1 | 0 | 0 0 H 0 | 0 0 H 0 | 2
0 2 - 6 = 5 - - 4 - 5 = = 6 = 5 |
1 | 0 H 0 | 0 2 - 1 | 0 0 0 0 H 2
| 4 = 7 - 3 0 | 2 = 4 - 2 - - 4 |
2 | 0 H 1 | 0 4 = 6 = 5 = 4 0 | |
| 4 = 5 | | 0 | 0 H 0 | 0 H 0 | 2
2 | 0 | | 4 = 6 - 5 - 3 - 6 - 3 |
| 2 0 | 2 | 0 H 0 | 0 0 0 H 0 | |
2 | 0 1 | 2 - 5 = 5 - - 1 H 0 | 2
| 4 - - 3 - 4 = 4 | 0 2 - 7 = 4 |
2 H 0 0 0 0 | 0 H 1 0 | 0 H 0 | 2
| 5 = 5 - - 5 - 4 - - 5 = 7 - 2 |
2 | 0 H 0 0 H 0 0 0 0 | 0 H 1 - 3
| 2 - 5 = = 5 - - 1 0 | 0 3 - 1 |
2 - 2 - - 2 - - 2 - - 3 - - 2 - 2