#17X17
0 1 - 3 = 3 - 2 - - 2 - 2 - 2 - 2
2 - 2 - 2 - 2 - 2 - - 3 = 4 = 2 |
| 0 0 0 0 0 0 0 0 0 1 - - - 2 - 3
2 - - 2 - 3 - 5 = 4 - - 2 - - 1 |
0 0 2 - 3 | 1 H 0 | 0 1 - - 2 - 3
0 0 | 0 H 2 | 3 - 4 = = 6 = = 2 |
2 - 6 = 5 | 5 = 5 - 2 0 H 1 - - 3
| 0 H 0 | 1 H 0 H 0 | 0 H 0 0 0 |
3 = 5 - 4 - 5 - 7 = 6 = 7 - 4 - 4
0 0 0 0 | 0 | 0 H 1 | 0 H 0 H 0 H
2 - - 1 | 0 3 = 4 | 4 - 7 = 7 = 5
| 2 = = 5 - - 4 - 2 H 0 H 0 | 0 |
3 - 3 0 | 1 0 H 2 - 6 = 6 = 3 0 |
| 1 H 0 1 | 0 2 | 0 | 1 - 4 = = 4
2 | 2 0 0 | 1 - 2 0 | 0 0 | 0 0 |
| 2 - 2 - 3 - 2 - - 4 = 2 | 1 - 2
2 - 2 - 2 - 2 - 2 - - 2 - 3 - 1 0