#17X17
1 - 3 0 1 0 0 1 0 3 = 3 - - 2 - 2
0 0 H 0 | 0 0 | 1 | 3 - - 4 - 2 |
2 - 7 = 6 = = 3 | 2 H 0 2 H 1 | 2
| 0 H 0 | 0 0 0 | | H 0 H 3 | 2 |
3 = 7 = 5 - 3 = 5 | 4 - 5 | 2 | |
0 1 | 0 | 0 0 0 H 1 | 0 H 1 | | 2
1 | | 0 3 = = = 6 - 4 = 6 = 4 | |
| | 3 - - - 3 0 | 0 0 0 0 0 | | 2
| 2 | 3 - 1 H 0 3 - - 2 - 1 | 2 |
2 | | H 0 0 H 1 | 0 3 - - - 3 | |
| | 2 H 3 - 4 | 2 0 H 0 1 0 | | 2
| 2 | 3 H 0 | 2 | 0 3 0 | 0 2 | |
| | 2 | 3 0 | | 2 0 | 0 2 0 | | 2
| 2 | 3 | 0 2 | | 0 1 0 | 0 | 1 |
2 | 1 H 1 0 | | | 3 = = 4 - 6 = 4
| 2 - 4 - - 2 | 1 | 0 0 0 0 H 0 |
2 - 2 - - 2 - 3 - 2 0 0 1 - 4 - 2