#17X17
2 - 2 - - 2 0 3 = 3 - - - 2 - 1 0
| 3 - 2 0 | 0 | 2 - - 5 = = 4 - 2
| H 0 | 0 4 = 3 | 0 0 H 0 0 | 0 |
2 H 0 | 0 | 1 - 4 - 1 H 1 - 2 0 |
| 4 = 5 - 4 - 3 | 1 - 6 = 6 = = 4
2 - 3 | 1 | 0 H 2 - 1 | 0 H 0 0 |
0 0 H 1 | 1 0 H 0 0 0 | 0 3 - 1 |
2 - 4 - 4 = = 7 = 6 = 5 - - 2 - 3
| 1 - 2 - 2 0 | 0 H 0 | 0 0 0 0 |
3 - 3 = 2 | 0 3 - 5 - 5 = 6 = 4 |
| 2 - 5 = 4 0 | 0 | 1 | 0 H 0 H 2
| | 2 H 0 | 0 | 2 | | | 0 H 0 H |
2 | H 3 - 4 - 2 H 1 | 5 = 8 = 5 |
| | 5 = 2 | 1 - 5 - 2 H 0 H 0 | 2
| 1 | 0 0 | 0 0 | 0 0 H 0 H 0 | |
2 - 3 - - 4 = = 4 - - 4 - 4 - 2 |
0 1 - - 3 = 3 - - - 2 - 2 - 2 - 2