#17X17
2 - 2 0 1 - - 2 0 1 0 2 - - 3 - 2
| 0 | 0 0 0 0 | 1 | 1 | 0 0 | 0 |
2 0 | 3 = 6 = 5 | 2 | 2 - 1 | 0 3
| 0 2 | 0 H 0 H 2 | 3 - 3 = 3 0 H
| 0 | 1 0 H 0 2 | 2 | 4 = 3 - - 5
2 - 5 - - 6 = = 3 | 1 H 0 0 0 0 H
0 0 H 0 0 | 1 - - 3 - 5 - - 1 0 H
1 0 H 3 - 3 - - 3 - 1 | 2 - - - 4
| 0 3 H 1 - - 2 | 0 0 | | 0 0 0 |
2 0 | 3 - - 1 | | 1 - 4 | 1 - - 3
| 0 3 = = 5 = 5 | 0 0 H 2 - - 1 |
3 - - - 1 | 0 H 3 - - 4 - - 4 - 3
| 2 - 2 - 3 - 4 | 4 = = 2 0 H 0 |
| | 2 - 2 - 1 | 1 H 0 1 - - 3 0 |
2 | | 1 - 4 = 5 - 5 = = = 2 0 0 2
| 1 | 0 0 | 0 | 0 0 0 0 0 0 0 0 |
2 - 3 - - 2 0 1 0 1 - 2 - - 2 - 2