#17X17
3 - - 3 = = 3 - - 2 0 1 - 2 - - 2
H 3 = = 5 - - 1 0 | 1 - 5 = = 3 |
3 | 0 0 H 0 1 - 2 | 0 0 H 0 1 | 3
| 4 = = 7 = = 3 | 2 - - 4 0 | 1 H
2 | 1 0 | 0 1 | 4 = 4 0 | 0 4 = 6
| 1 | 0 2 0 | 1 | 0 H 0 | 0 | 0 H
2 - 4 0 | 0 4 - 6 = 8 = 5 - 5 - 5
0 0 H 0 | 0 H 0 H 0 H 0 | 0 H 0 H
2 - 7 = 5 - 7 = 6 - 7 = 6 = 8 = 5
| 0 H 0 | 0 H 0 | 0 H 0 | 0 H 0 |
3 = 7 - 5 = 7 - 5 = 5 0 | 0 4 - 3
0 0 H 0 | 0 H 0 | 1 | 0 3 0 | 1 |
2 - 4 0 | 0 4 = 5 | 1 0 H 0 1 | 3
| 0 | 0 2 - - 3 H 2 - - 7 = = 4 H
| 0 2 - - 1 0 H 4 - 1 0 H 0 0 | 3
2 - - - 3 = = 4 | 1 - - 5 = = 3 |
0 1 - 3 = 3 - - 2 0 1 - - - 2 - 2