#17X17
0 1 - 3 0 1 0 2 0 3 = 3 - 2 - 1 0
1 0 0 H 0 | 0 H 0 | 3 - 3 - 2 - 2
| 2 - 5 = 3 0 H 0 | H 1 | 0 0 0 |
3 | 1 - 3 - - 7 = 4 H | 3 - - 2 |
H 5 = 2 | 0 0 H 0 | 2 | | 0 0 | 3
3 H 0 0 | 3 - 7 = 5 - 3 | 3 - 3 H
| 5 = = 3 H 0 H 0 | 0 | 3 H 0 | 3
3 | 0 1 - 3 0 H 0 | 0 1 H 4 = 5 |
H | 3 = 4 = = 6 - 5 - - 5 - 3 H |
H 3 | 4 = 3 0 | 0 H 0 1 | 1 H H 2
3 H 3 H 0 | 0 | 0 H 0 | 2 | H 4 |
| 3 H 3 - 3 - 4 = 7 = 5 | | 2 H 3
3 | 3 - - - 2 - 1 | 0 H | 2 - 4 H
H 2 - - 3 - - 4 = 4 0 H 1 0 0 | 3
H 0 0 0 | 0 0 | 0 | 0 5 = = 2 | |
3 - 2 - 3 - 1 | 0 | 0 | 0 0 0 | 1
0 1 - 3 = 3 - 2 0 1 0 3 = 3 - 2 0