#17X17
0 2 = 3 - - 3 = = 3 - - 2 0 1 - 2
2 - 3 = 5 - - 3 - - 3 0 | 3 = 4 |
| 0 0 0 H 0 0 | 0 0 H 0 2 | 0 H 2
| 1 - - 6 = = 7 = 2 H 0 | 3 - 5 |
| 0 0 0 | 0 0 H 3 - 7 = 3 | 0 H 3
3 0 3 = 7 = = 5 H 1 H 2 = 5 = 5 H
H 2 | 0 H 0 0 | H | 3 - 3 - 1 | 3
3 H 1 0 H 0 0 | 2 | 0 0 | 0 0 | |
| 5 = = 7 - - 4 - 4 - - 4 = = 5 |
2 | 0 1 H 1 0 | 0 | 0 0 0 0 0 H 3
| | 0 | 4 | 0 | 0 3 = 4 - 2 0 H H
| 2 - 2 H 5 = 5 - - 1 | 2 | 0 3 H
| 0 0 0 H H 0 | 4 = = 4 H 1 0 | 3
2 0 2 = 5 H 0 1 H 0 0 | 5 - - 3 |
| 0 0 0 | 3 - - 5 = = 3 H 0 0 | 2
2 - - 1 | 0 1 - - 2 - - 5 = = 3 |
0 1 - - 3 - - 2 - - - 3 = 3 - - 2