#17X17
0 2 - 2 - 3 - - 3 = 3 - - 2 - 1 0
1 | 0 0 0 | 2 - - 5 = 4 - - 5 = 3
| | 3 - 2 | | 0 0 H 0 | 0 0 H 0 |
| 3 H 0 | | 4 = = 5 - 5 = = 7 = 5
2 H 2 0 | 1 | 0 0 0 0 | 0 0 | 0 H
| 5 = = 4 - 5 - 5 = 3 | 1 - 5 - 4
2 | 2 - - 1 H 0 H 0 | 2 - 1 H 0 |
| 1 | 0 4 = 7 = 7 - 5 = 6 = 7 = 5
| 0 | 0 H 0 | 0 H 0 | 0 H 0 | 0 H
3 - 3 - 6 - 4 - 7 = 5 - 5 0 | 0 H
| 0 0 0 H 0 | 0 H 0 | 0 H 0 3 = 5
| 3 - - 5 = 5 = 5 - 6 = 7 - - 2 |
2 H 0 0 0 0 0 0 0 0 H 0 H 0 1 | 2
| H 1 - - 4 - 5 = = 6 - 5 0 | | |
| 4 - 1 0 H 0 H 0 0 | 2 H 0 | 3 |
1 | 1 - - 5 = 5 - - 2 H 3 - 2 H 1
0 3 = 3 - - 2 - - 2 - 4 - 2 - 3 0