#17X17
0 0 1 - 2 - - 2 0 1 0 1 0 1 - - 3
2 - - 5 = 2 0 | 0 | 0 | 1 - - 2 H
| 1 0 H 2 - - 5 = 5 = 5 = = 3 | 3
3 | 0 H | 0 0 | 1 - - - - 2 | 2 |
H 4 = 6 | 1 - 5 - - 2 - 1 | 1 | 3
3 | 0 H 2 - 1 H 1 - - 5 = 5 - 4 H
| | 0 H 0 0 0 4 = = 3 H 0 | 0 H 3
| 4 - 6 - 4 - - 2 0 | 3 - 5 = 6 |
2 H 0 H 0 H 0 0 | 0 | 0 0 | 0 H 3
| 6 = 8 = 8 = = 5 - 4 - - 4 - 5 H
3 H 0 H 0 H 0 0 | 1 | 0 0 | 0 H H
H 5 - 5 - 5 - - 2 | 2 - 1 | 0 H 3
3 H 1 | 0 | 3 = = 6 - 2 - 5 = 5 |
| 3 | 1 0 | | 0 0 H 0 0 0 | 0 | 2
3 | 3 = = 4 | 3 = 7 - - 1 | 0 1 |
H 3 = = 2 | 1 | 0 H 0 1 - 3 - - 2
3 - - 2 - 2 0 2 - 4 - - 2 - 1 0 0