#17X17
1 0 2 = = = 3 - 2 - 3 - - 2 - 1 0
| 1 - - 4 = = 5 - 2 | 0 3 = 4 = 3
4 - 2 0 | 0 0 H 1 | 2 0 | 2 - 1 |
H 0 | 0 | 0 0 H | 3 | 0 1 | 1 - 3
4 = 7 = 6 = = 6 | H 2 0 0 | 0 0 |
0 0 H 1 | 0 0 H | 3 | 1 - 5 - - 3
0 0 2 | 2 - - 3 | | | 0 0 H 0 0 |
2 - - 5 - 3 - - 2 | 3 = = 7 = = 5
| 0 0 H 1 | 0 2 - 5 - - 2 | 0 0 H
3 = = 6 | 2 0 | 0 H 0 0 | 4 = = 5
0 0 0 H 3 | 0 4 = 8 = = 4 | 1 0 |
2 - - 4 H 1 0 | 2 H 0 0 | 1 | 0 |
| 0 0 | H 0 0 | H 5 - - 4 - 6 = 4
3 - 1 | 4 = = 3 H H 0 0 | 0 H 0 |
| 2 = 4 - 2 - - 3 H 0 0 | 0 3 - 3
2 - 3 = 3 - - 3 = 6 = = 4 - - 1 |
0 1 - 2 - 3 = = 3 - - 3 = = 3 - 2