#17X17
0 1 - - 3 0 1 - 3 = 3 - - 2 - - 2
1 0 0 0 H 2 = = = 3 - - 4 = 4 0 |
| 2 - - 6 - - 2 - - - 1 | 0 H 0 |
3 | 0 0 H 0 1 - 3 = 5 = 5 - 6 = 4
H 5 = 2 H 1 - - - 2 | 1 | 0 | 0 |
3 H 3 = 5 - - 3 0 | 1 | 1 0 | 2 |
| 3 | 4 = 3 0 H 0 4 = 7 = = 5 H 2
3 | 2 H 0 | 0 H 0 | 0 H 0 0 H 3 |
H 2 | 3 - 5 - 5 - 5 - 6 - - 5 | 2
H | | 0 0 H 0 | 1 H 0 H 0 0 H | |
3 | 4 = = 6 = 3 | H 0 3 - 1 H 2 |
| 1 | 0 0 0 0 0 | 3 - - 4 - 3 | 3
2 - 6 = 4 - 3 = 5 - - 1 H 1 - 3 H
0 0 H 0 | 4 = 3 | 0 0 0 H 0 0 | 3
1 0 H 0 1 H 0 | 4 = 5 = 5 - - 4 |
| 0 3 - - 4 - 2 | 0 | 0 0 0 0 H 1
2 - - 3 = = 3 - 2 0 1 0 1 - - 3 0