#17X17
3 - 4 = = 4 0 3 = 3 - - 2 - - 2 0
H 1 | 0 0 H 0 | 3 = = 3 - - 1 | 1
3 | | 0 0 H 0 1 | 1 - - 4 - - 4 |
| | 2 - - 7 = = 5 - - 1 H 1 0 H 3
| 4 = = 2 H 0 0 | 0 4 = 5 | 0 H H
| | 0 0 0 H 0 0 | 0 H 0 | 4 - 4 H
3 | 3 = = 6 - - 3 - 4 - 2 H 0 | 3
H 2 | 1 0 | 1 - - 2 - 4 = 7 = 5 |
3 | 1 | 0 | 0 0 0 0 0 | 1 | 0 H 2
| 2 - 3 - 3 - 2 - - 1 | | 2 0 H |
2 0 1 - 5 = 4 - 3 = = 5 | | 0 3 |
| 3 - 2 H 0 | 2 = 3 0 H | 1 0 | 3
| H 0 | 5 = 5 = 3 | 0 H 3 - - 2 H
2 H 0 1 | 0 0 0 | 4 = 5 | 0 3 = 5
| 5 = = 6 - - 1 | | 0 | 1 0 | 0 |
1 | 0 0 H 0 0 0 | 1 0 | 0 0 | 0 1
0 2 - - 3 0 1 - 2 0 0 2 - - 2 0 0